DEBUG: _CALLEE_DEALLOC macro on "p3" (LINE:182 FILE: rectangle.c) in naive_dealloc folder	Frequency: 1
DEBUG: _CALLER_DEALLOC macro on "rec" (LINE:180 FILE: rectangle.c) in naive_dealloc folder	Frequency: 1
DEBUG: _RESET_DEALLOC macro on "p3" (LINE:182 FILE: rectangle.c) in copy_reduced_dealloc folder	Frequency: 1
DEBUG: _RESET_DEALLOC macro on "rec" (LINE:180 FILE: rectangle.c) in copy_reduced_dealloc folder	Frequency: 1
DEBUG: _CALLEE_DEALLOC macro on "_11" (LINE:159 FILE: reverse.c) in naive_dealloc folder	Frequency: 1
DEBUG: _CALLEE_DEALLOC macro on "arr" (LINE:240 FILE: reverse.c) in naive_dealloc folder	Frequency: 1
DEBUG: _RETAIN_DEALLOC macro on "_11" (LINE:158 FILE: reverse.c) in copy_reduced_dealloc folder	Frequency: 1
DEBUG: _RETAIN_DEALLOC macro on "arr" (LINE:238 FILE: reverse.c) in copy_reduced_dealloc folder	Frequency: 1
DEBUG: _CALLER_DEALLOC macro on "ys" (LINE:516 FILE: mergesort.c) in naive_dealloc folder	Frequency: 1
DEBUG: _CALLER_DEALLOC macro on "ys" (LINE:577 FILE: mergesort.c) in naive_dealloc folder	Frequency: 1
DEBUG: _CALLER_DEALLOC macro on "rhs" (LINE:116 FILE: mergesort.c) in naive_dealloc folder	Frequency: 24
DEBUG: _CALLER_DEALLOC macro on "arr" (LINE:664 FILE: mergesort.c) in naive_dealloc folder	Frequency: 1
DEBUG: _CALLER_DEALLOC macro on "ys" (LINE:396 FILE: mergesort.c) in naive_dealloc folder	Frequency: 1
DEBUG: _CALLER_DEALLOC macro on "lhs" (LINE:89 FILE: mergesort.c) in naive_dealloc folder	Frequency: 24
DEBUG: _CALLER_DEALLOC macro on "ys" (LINE:457 FILE: mergesort.c) in naive_dealloc folder	Frequency: 1
DEBUG: _RESET_DEALLOC macro on "arr" (LINE:657 FILE: mergesort.c) in copy_reduced_dealloc folder	Frequency: 1
DEBUG: _RESET_DEALLOC macro on "ys" (LINE:453 FILE: mergesort.c) in copy_reduced_dealloc folder	Frequency: 1
DEBUG: _RESET_DEALLOC macro on "lhs" (LINE:88 FILE: mergesort.c) in copy_reduced_dealloc folder	Frequency: 24
DEBUG: _RESET_DEALLOC macro on "ys" (LINE:393 FILE: mergesort.c) in copy_reduced_dealloc folder	Frequency: 1
DEBUG: _RESET_DEALLOC macro on "rhs" (LINE:114 FILE: mergesort.c) in copy_reduced_dealloc folder	Frequency: 24
DEBUG: _RESET_DEALLOC macro on "ys" (LINE:511 FILE: mergesort.c) in copy_reduced_dealloc folder	Frequency: 1
DEBUG: _RESET_DEALLOC macro on "ys" (LINE:571 FILE: mergesort.c) in copy_reduced_dealloc folder	Frequency: 1
DEBUG: _CALLER_DEALLOC macro on "ys" (LINE:231 FILE: bubblesort.c) in naive_dealloc folder	Frequency: 1
DEBUG: _RESET_DEALLOC macro on "ys" (LINE:230 FILE: bubblesort.c) in copy_reduced_dealloc folder	Frequency: 1
DEBUG: _CALLEE_DEALLOC macro on "C" (LINE:620 FILE: MatrixMult.c) in naive_dealloc folder	Frequency: 1
DEBUG: _CALLEE_DEALLOC macro on "A" (LINE:576 FILE: MatrixMult.c) in naive_dealloc folder	Frequency: 1
DEBUG: _CALLEE_DEALLOC macro on "B" (LINE:578 FILE: MatrixMult.c) in naive_dealloc folder	Frequency: 1
DEBUG: _CALLEE_DEALLOC macro on "rows" (LINE:419 FILE: MatrixMult.c) in naive_dealloc folder	Frequency: 2
DEBUG: _CALLEE_DEALLOC macro on "C_data" (LINE:216 FILE: MatrixMult.c) in naive_dealloc folder	Frequency: 1
DEBUG: _RETAIN_DEALLOC macro on "B" (LINE:575 FILE: MatrixMult.c) in copy_reduced_dealloc folder	Frequency: 1
DEBUG: _RETAIN_DEALLOC macro on "C" (LINE:616 FILE: MatrixMult.c) in copy_reduced_dealloc folder	Frequency: 1
DEBUG: _RESET_DEALLOC macro on "C_data" (LINE:216 FILE: MatrixMult.c) in copy_reduced_dealloc folder	Frequency: 1
DEBUG: _RETAIN_DEALLOC macro on "A" (LINE:573 FILE: MatrixMult.c) in copy_reduced_dealloc folder	Frequency: 1
DEBUG: _RESET_DEALLOC macro on "rows" (LINE:418 FILE: MatrixMult.c) in copy_reduced_dealloc folder	Frequency: 2
DEBUG: Memory leaks at "arr"_tmp (LINE:137 FILE: Fibonacci.c) in naive_dealloc folder	Frequency: 1
DEBUG: _CALLER_DEALLOC macro on "ls" (LINE:52 FILE: Fibonacci.c) in naive_dealloc folder	Frequency: 8
DEBUG: _CALLER_DEALLOC macro on "arr" (LINE:137 FILE: Fibonacci.c) in naive_dealloc folder	Frequency: 1
DEBUG: Memory leaks at "ls"_tmp (LINE:52 FILE: Fibonacci.c) in naive_dealloc folder	Frequency: 7
DEBUG: _RESET_DEALLOC macro on "arr" (LINE:135 FILE: Fibonacci.c) in copy_reduced_dealloc folder	Frequency: 1
DEBUG: _RESET_DEALLOC macro on "ls" (LINE:51 FILE: Fibonacci.c) in copy_reduced_dealloc folder	Frequency: 8
DEBUG: _CALLEE_DEALLOC macro on "A" (LINE:675 FILE: MatrixMult2.c) in naive_dealloc folder	Frequency: 1
DEBUG: _CALLEE_DEALLOC macro on "data" (LINE:145 FILE: MatrixMult2.c) in naive_dealloc folder	Frequency: 2
DEBUG: _CALLEE_DEALLOC macro on "data" (LINE:442 FILE: MatrixMult2.c) in naive_dealloc folder	Frequency: 1
DEBUG: _CALLEE_DEALLOC macro on "B" (LINE:677 FILE: MatrixMult2.c) in naive_dealloc folder	Frequency: 1
DEBUG: _CALLEE_DEALLOC macro on "C" (LINE:726 FILE: MatrixMult2.c) in naive_dealloc folder	Frequency: 1
DEBUG: _RETAIN_DEALLOC macro on "B" (LINE:674 FILE: MatrixMult2.c) in copy_reduced_dealloc folder	Frequency: 1
DEBUG: _RETAIN_DEALLOC macro on "C" (LINE:722 FILE: MatrixMult2.c) in copy_reduced_dealloc folder	Frequency: 1
DEBUG: _RESET_DEALLOC macro on "data" (LINE:145 FILE: MatrixMult2.c) in copy_reduced_dealloc folder	Frequency: 2
DEBUG: _RETAIN_DEALLOC macro on "A" (LINE:672 FILE: MatrixMult2.c) in copy_reduced_dealloc folder	Frequency: 1
DEBUG: _RESET_DEALLOC macro on "data" (LINE:441 FILE: MatrixMult2.c) in copy_reduced_dealloc folder	Frequency: 1
DEBUG: _CALLEE_DEALLOC macro on "A" (LINE:771 FILE: MatrixMult3.c) in naive_dealloc folder	Frequency: 1
DEBUG: _CALLEE_DEALLOC macro on "data" (LINE:536 FILE: MatrixMult3.c) in naive_dealloc folder	Frequency: 1
DEBUG: _CALLEE_DEALLOC macro on "C" (LINE:822 FILE: MatrixMult3.c) in naive_dealloc folder	Frequency: 1
DEBUG: _CALLEE_DEALLOC macro on "B" (LINE:773 FILE: MatrixMult3.c) in naive_dealloc folder	Frequency: 1
DEBUG: _CALLEE_DEALLOC macro on "data" (LINE:145 FILE: MatrixMult3.c) in naive_dealloc folder	Frequency: 2
DEBUG: _RESET_DEALLOC macro on "data" (LINE:145 FILE: MatrixMult3.c) in copy_reduced_dealloc folder	Frequency: 2
DEBUG: _RETAIN_DEALLOC macro on "C" (LINE:818 FILE: MatrixMult3.c) in copy_reduced_dealloc folder	Frequency: 1
DEBUG: _RETAIN_DEALLOC macro on "B" (LINE:770 FILE: MatrixMult3.c) in copy_reduced_dealloc folder	Frequency: 1
DEBUG: _RETAIN_DEALLOC macro on "A" (LINE:768 FILE: MatrixMult3.c) in copy_reduced_dealloc folder	Frequency: 1
DEBUG: _RESET_DEALLOC macro on "data" (LINE:535 FILE: MatrixMult3.c) in copy_reduced_dealloc folder	Frequency: 1
DEBUG: _CALLEE_DEALLOC macro on "gcds" (LINE:218 FILE: gcd.c) in naive_dealloc folder	Frequency: 100
DEBUG: _RETAIN_DEALLOC macro on "gcds" (LINE:217 FILE: gcd.c) in copy_reduced_dealloc folder	Frequency: 100
DEBUG: _CALLEE_DEALLOC macro on "moves" (LINE:571 FILE: CoinGame.c) in naive_dealloc folder	Frequency: 1
DEBUG: _CALLER_DEALLOC macro on "moves" (LINE:559 FILE: CoinGame.c) in naive_dealloc folder	Frequency: 1
DEBUG: _RETAIN_DEALLOC macro on "moves" (LINE:569 FILE: CoinGame.c) in copy_reduced_dealloc folder	Frequency: 1
DEBUG: _RESET_DEALLOC macro on "moves" (LINE:558 FILE: CoinGame.c) in copy_reduced_dealloc folder	Frequency: 1
DEBUG: _CALLER_DEALLOC macro on "moves" (LINE:256 FILE: CoinGame1.c) in naive_dealloc folder	Frequency: 1
DEBUG: _RESET_DEALLOC macro on "moves" (LINE:255 FILE: CoinGame1.c) in copy_reduced_dealloc folder	Frequency: 1
DEBUG: _CALLER_DEALLOC macro on "moves" (LINE:359 FILE: CoinGame2.c) in naive_dealloc folder	Frequency: 1
DEBUG: _RESET_DEALLOC macro on "moves" (LINE:358 FILE: CoinGame2.c) in copy_reduced_dealloc folder	Frequency: 1
DEBUG: _CALLER_DEALLOC macro on "moves" (LINE:334 FILE: CoinGame3.c) in naive_dealloc folder	Frequency: 1
DEBUG: _RESET_DEALLOC macro on "moves" (LINE:333 FILE: CoinGame3.c) in copy_reduced_dealloc folder	Frequency: 1
DEBUG: _CALLER_DEALLOC macro on "moves" (LINE:507 FILE: CoinGame4.c) in naive_dealloc folder	Frequency: 55
DEBUG: _CALLER_DEALLOC macro on "moves" (LINE:592 FILE: CoinGame4.c) in naive_dealloc folder	Frequency: 1
DEBUG: Memory leaks at "moves"_tmp (LINE:592 FILE: CoinGame4.c) in naive_dealloc folder	Frequency: 1
DEBUG: _CALLEE_DEALLOC macro on "moves" (LINE:604 FILE: CoinGame4.c) in naive_dealloc folder	Frequency: 1
DEBUG: _RETAIN_DEALLOC macro on "moves" (LINE:601 FILE: CoinGame4.c) in copy_reduced_dealloc folder	Frequency: 1
DEBUG: _RESET_DEALLOC macro on "moves" (LINE:590 FILE: CoinGame4.c) in copy_reduced_dealloc folder	Frequency: 1
DEBUG: _RESET_DEALLOC macro on "moves" (LINE:506 FILE: CoinGame4.c) in copy_reduced_dealloc folder	Frequency: 55
DEBUG: _CALLEE_DEALLOC macro on "p" (LINE:315 FILE: nqueens.c) in naive_dealloc folder	Frequency: 46752
DEBUG: Memory leaks at "nq"_tmp (LINE:374 FILE: nqueens.c) in naive_dealloc folder	Frequency: 1320
DEBUG: _CALLER_DEALLOC macro on "nq" (LINE:374 FILE: nqueens.c) in naive_dealloc folder	Frequency: 2056
DEBUG: _CALLER_DEALLOC macro on "nq" (LINE:497 FILE: nqueens.c) in naive_dealloc folder	Frequency: 1
DEBUG: _CALLEE_DEALLOC macro on "queens" (LINE:482 FILE: nqueens.c) in naive_dealloc folder	Frequency: 1
DEBUG: Memory leaks at "nq"_tmp (LINE:497 FILE: nqueens.c) in naive_dealloc folder	Frequency: 1
DEBUG: _RESET_DEALLOC macro on "nq" (LINE:373 FILE: nqueens.c) in copy_reduced_dealloc folder	Frequency: 2056
DEBUG: _RETAIN_DEALLOC macro on "p" (LINE:315 FILE: nqueens.c) in copy_reduced_dealloc folder	Frequency: 46752
DEBUG: _RESET_DEALLOC macro on "queens" (LINE:480 FILE: nqueens.c) in copy_reduced_dealloc folder	Frequency: 1
DEBUG: _RESET_DEALLOC macro on "nq" (LINE:494 FILE: nqueens.c) in copy_reduced_dealloc folder	Frequency: 1
DEBUG: _CALLEE_DEALLOC macro on "queens" (LINE:377 FILE: nqueens2.c) in naive_dealloc folder	Frequency: 1
DEBUG: _CALLEE_DEALLOC macro on "p" (LINE:228 FILE: nqueens2.c) in naive_dealloc folder	Frequency: 46752
DEBUG: _CALLEE_DEALLOC macro on "queens" (LINE:286 FILE: nqueens2.c) in naive_dealloc folder	Frequency: 2056
DEBUG: _CALLEE_DEALLOC macro on "queens" (LINE:376 FILE: nqueens2.c) in copy_reduced_dealloc folder	Frequency: 1
DEBUG: _RETAIN_DEALLOC macro on "p" (LINE:227 FILE: nqueens2.c) in copy_reduced_dealloc folder	Frequency: 46752
DEBUG: _CALLEE_DEALLOC macro on "queens" (LINE:285 FILE: nqueens2.c) in copy_reduced_dealloc folder	Frequency: 2056
DEBUG: _CALLEE_DEALLOC macro on "b" (LINE:171 FILE: FunctionCall1.c) in naive_dealloc folder	Frequency: 1
DEBUG: _CALLEE_DEALLOC macro on "a" (LINE:104 FILE: FunctionCall1.c) in naive_dealloc folder	Frequency: 1
DEBUG: _CALLER_DEALLOC macro on "b" (LINE:170 FILE: FunctionCall1.c) in copy_reduced_dealloc folder	Frequency: 1
DEBUG: _RESET_DEALLOC macro on "a" (LINE:103 FILE: FunctionCall1.c) in copy_reduced_dealloc folder	Frequency: 1
DEBUG: _CALLER_DEALLOC macro on "a" (LINE:123 FILE: FunctionCall2.c) in naive_dealloc folder	Frequency: 1
DEBUG: Memory leaks at "a"_tmp (LINE:123 FILE: FunctionCall2.c) in naive_dealloc folder	Frequency: 1
DEBUG: _CALLER_DEALLOC macro on "b" (LINE:192 FILE: FunctionCall2.c) in naive_dealloc folder	Frequency: 1
DEBUG: _CALLER_DEALLOC macro on "b" (LINE:191 FILE: FunctionCall2.c) in copy_reduced_dealloc folder	Frequency: 1
DEBUG: _RESET_DEALLOC macro on "a" (LINE:122 FILE: FunctionCall2.c) in copy_reduced_dealloc folder	Frequency: 1
DEBUG: _CALLEE_DEALLOC macro on "b" (LINE:163 FILE: FunctionCall3.c) in naive_dealloc folder	Frequency: 1
DEBUG: _CALLEE_DEALLOC macro on "a" (LINE:96 FILE: FunctionCall3.c) in naive_dealloc folder	Frequency: 1
DEBUG: _RESET_DEALLOC macro on "a" (LINE:95 FILE: FunctionCall3.c) in copy_reduced_dealloc folder	Frequency: 1
DEBUG: _CALLER_DEALLOC macro on "b" (LINE:162 FILE: FunctionCall3.c) in copy_reduced_dealloc folder	Frequency: 1
DEBUG: _CALLEE_DEALLOC macro on "a" (LINE:155 FILE: FunctionCall4.c) in naive_dealloc folder	Frequency: 1
DEBUG: _CALLEE_DEALLOC macro on "b" (LINE:224 FILE: FunctionCall4.c) in naive_dealloc folder	Frequency: 1
DEBUG: _CALLER_DEALLOC macro on "b" (LINE:223 FILE: FunctionCall4.c) in copy_reduced_dealloc folder	Frequency: 1
DEBUG: Memory leaks at "b"_tmp (LINE:223 FILE: FunctionCall4.c) in copy_reduced_dealloc folder	Frequency: 1
DEBUG: _RESET_DEALLOC macro on "a" (LINE:154 FILE: FunctionCall4.c) in copy_reduced_dealloc folder	Frequency: 1
DEBUG: _CALLEE_DEALLOC macro on "pixels" (LINE:309 FILE: SobelEdgeDetect.c) in naive_dealloc folder	Frequency: 64
DEBUG: _CALLEE_DEALLOC macro on "h_sobel" (LINE:323 FILE: SobelEdgeDetect.c) in naive_dealloc folder	Frequency: 64
DEBUG: _CALLEE_DEALLOC macro on "pixels" (LINE:657 FILE: SobelEdgeDetect.c) in naive_dealloc folder	Frequency: 1
DEBUG: _CALLEE_DEALLOC macro on "newPixels" (LINE:673 FILE: SobelEdgeDetect.c) in naive_dealloc folder	Frequency: 1
DEBUG: _CALLEE_DEALLOC macro on "pixels" (LINE:636 FILE: SobelEdgeDetect.c) in naive_dealloc folder	Frequency: 1
DEBUG: _CALLEE_DEALLOC macro on "v_sobel" (LINE:311 FILE: SobelEdgeDetect.c) in naive_dealloc folder	Frequency: 64
DEBUG: _CALLEE_DEALLOC macro on "pixels" (LINE:321 FILE: SobelEdgeDetect.c) in naive_dealloc folder	Frequency: 64
DEBUG: _RETAIN_DEALLOC macro on "pixels" (LINE:317 FILE: SobelEdgeDetect.c) in copy_reduced_dealloc folder	Frequency: 64
DEBUG: _RETAIN_DEALLOC macro on "newPixels" (LINE:666 FILE: SobelEdgeDetect.c) in copy_reduced_dealloc folder	Frequency: 1
DEBUG: _RETAIN_DEALLOC macro on "pixels" (LINE:307 FILE: SobelEdgeDetect.c) in copy_reduced_dealloc folder	Frequency: 64
DEBUG: _RETAIN_DEALLOC macro on "v_sobel" (LINE:309 FILE: SobelEdgeDetect.c) in copy_reduced_dealloc folder	Frequency: 64
DEBUG: _RETAIN_DEALLOC macro on "pixels" (LINE:631 FILE: SobelEdgeDetect.c) in copy_reduced_dealloc folder	Frequency: 1
DEBUG: _RETAIN_DEALLOC macro on "h_sobel" (LINE:319 FILE: SobelEdgeDetect.c) in copy_reduced_dealloc folder	Frequency: 64
DEBUG: _RETAIN_DEALLOC macro on "pixels" (LINE:651 FILE: SobelEdgeDetect.c) in copy_reduced_dealloc folder	Frequency: 1
DEBUG: _CALLEE_DEALLOC macro on "pixels" (LINE:629 FILE: SobelEdgeDetect1.c) in naive_dealloc folder	Frequency: 1
DEBUG: _CALLEE_DEALLOC macro on "pixels" (LINE:321 FILE: SobelEdgeDetect1.c) in naive_dealloc folder	Frequency: 64
DEBUG: _CALLEE_DEALLOC macro on "h_sobel" (LINE:323 FILE: SobelEdgeDetect1.c) in naive_dealloc folder	Frequency: 64
DEBUG: _CALLEE_DEALLOC macro on "pixels" (LINE:309 FILE: SobelEdgeDetect1.c) in naive_dealloc folder	Frequency: 64
DEBUG: _CALLEE_DEALLOC macro on "newPixels" (LINE:645 FILE: SobelEdgeDetect1.c) in naive_dealloc folder	Frequency: 1
DEBUG: _CALLEE_DEALLOC macro on "pixels" (LINE:608 FILE: SobelEdgeDetect1.c) in naive_dealloc folder	Frequency: 1
DEBUG: _CALLEE_DEALLOC macro on "v_sobel" (LINE:311 FILE: SobelEdgeDetect1.c) in naive_dealloc folder	Frequency: 64
DEBUG: _RETAIN_DEALLOC macro on "pixels" (LINE:317 FILE: SobelEdgeDetect1.c) in copy_reduced_dealloc folder	Frequency: 64
DEBUG: _RETAIN_DEALLOC macro on "pixels" (LINE:623 FILE: SobelEdgeDetect1.c) in copy_reduced_dealloc folder	Frequency: 1
DEBUG: _RETAIN_DEALLOC macro on "v_sobel" (LINE:309 FILE: SobelEdgeDetect1.c) in copy_reduced_dealloc folder	Frequency: 64
DEBUG: _RETAIN_DEALLOC macro on "newPixels" (LINE:638 FILE: SobelEdgeDetect1.c) in copy_reduced_dealloc folder	Frequency: 1
DEBUG: _RETAIN_DEALLOC macro on "pixels" (LINE:603 FILE: SobelEdgeDetect1.c) in copy_reduced_dealloc folder	Frequency: 1
DEBUG: _RETAIN_DEALLOC macro on "h_sobel" (LINE:319 FILE: SobelEdgeDetect1.c) in copy_reduced_dealloc folder	Frequency: 64
DEBUG: _RETAIN_DEALLOC macro on "pixels" (LINE:307 FILE: SobelEdgeDetect1.c) in copy_reduced_dealloc folder	Frequency: 64
DEBUG: _CALLEE_DEALLOC macro on "h_sobel" (LINE:420 FILE: SobelEdgeDetect2.c) in naive_dealloc folder	Frequency: 64
DEBUG: _CALLEE_DEALLOC macro on "v_sobel" (LINE:408 FILE: SobelEdgeDetect2.c) in naive_dealloc folder	Frequency: 64
DEBUG: _CALLEE_DEALLOC macro on "pixels" (LINE:728 FILE: SobelEdgeDetect2.c) in naive_dealloc folder	Frequency: 1
DEBUG: _CALLEE_DEALLOC macro on "input" (LINE:418 FILE: SobelEdgeDetect2.c) in naive_dealloc folder	Frequency: 64
DEBUG: _CALLEE_DEALLOC macro on "newPixels" (LINE:478 FILE: SobelEdgeDetect2.c) in naive_dealloc folder	Frequency: 1
DEBUG: _CALLEE_DEALLOC macro on "output" (LINE:778 FILE: SobelEdgeDetect2.c) in naive_dealloc folder	Frequency: 1
DEBUG: _CALLEE_DEALLOC macro on "input" (LINE:762 FILE: SobelEdgeDetect2.c) in naive_dealloc folder	Frequency: 1
DEBUG: _CALLEE_DEALLOC macro on "input" (LINE:741 FILE: SobelEdgeDetect2.c) in naive_dealloc folder	Frequency: 1
DEBUG: _CALLEE_DEALLOC macro on "input" (LINE:406 FILE: SobelEdgeDetect2.c) in naive_dealloc folder	Frequency: 64
DEBUG: _RETAIN_DEALLOC macro on "input" (LINE:735 FILE: SobelEdgeDetect2.c) in copy_reduced_dealloc folder	Frequency: 1
DEBUG: _RETAIN_DEALLOC macro on "output" (LINE:770 FILE: SobelEdgeDetect2.c) in copy_reduced_dealloc folder	Frequency: 1
DEBUG: _RETAIN_DEALLOC macro on "input" (LINE:755 FILE: SobelEdgeDetect2.c) in copy_reduced_dealloc folder	Frequency: 1
DEBUG: _RESET_DEALLOC macro on "pixels" (LINE:723 FILE: SobelEdgeDetect2.c) in copy_reduced_dealloc folder	Frequency: 1
DEBUG: _RETAIN_DEALLOC macro on "input" (LINE:415 FILE: SobelEdgeDetect2.c) in copy_reduced_dealloc folder	Frequency: 64
DEBUG: _RETAIN_DEALLOC macro on "v_sobel" (LINE:407 FILE: SobelEdgeDetect2.c) in copy_reduced_dealloc folder	Frequency: 64
DEBUG: _RETAIN_DEALLOC macro on "h_sobel" (LINE:417 FILE: SobelEdgeDetect2.c) in copy_reduced_dealloc folder	Frequency: 64
DEBUG: _RESET_DEALLOC macro on "newPixels" (LINE:474 FILE: SobelEdgeDetect2.c) in copy_reduced_dealloc folder	Frequency: 1
DEBUG: _RETAIN_DEALLOC macro on "input" (LINE:405 FILE: SobelEdgeDetect2.c) in copy_reduced_dealloc folder	Frequency: 64
DEBUG: _CALLEE_DEALLOC macro on "p3" (LINE:182 FILE: rectangle.c) in naive_dealloc folder	Frequency: 1
DEBUG: _CALLER_DEALLOC macro on "rec" (LINE:180 FILE: rectangle.c) in naive_dealloc folder	Frequency: 1
DEBUG: _RESET_DEALLOC macro on "p3" (LINE:182 FILE: rectangle.c) in copy_reduced_dealloc folder	Frequency: 1
DEBUG: _RESET_DEALLOC macro on "rec" (LINE:180 FILE: rectangle.c) in copy_reduced_dealloc folder	Frequency: 1
DEBUG: _CALLEE_DEALLOC macro on "_11" (LINE:159 FILE: reverse.c) in naive_dealloc folder	Frequency: 1
DEBUG: _CALLEE_DEALLOC macro on "arr" (LINE:240 FILE: reverse.c) in naive_dealloc folder	Frequency: 1
DEBUG: _RETAIN_DEALLOC macro on "_11" (LINE:158 FILE: reverse.c) in copy_reduced_dealloc folder	Frequency: 1
DEBUG: _RETAIN_DEALLOC macro on "arr" (LINE:238 FILE: reverse.c) in copy_reduced_dealloc folder	Frequency: 1
DEBUG: _CALLER_DEALLOC macro on "ys" (LINE:516 FILE: mergesort.c) in naive_dealloc folder	Frequency: 1
DEBUG: _CALLER_DEALLOC macro on "ys" (LINE:577 FILE: mergesort.c) in naive_dealloc folder	Frequency: 1
DEBUG: _CALLER_DEALLOC macro on "rhs" (LINE:116 FILE: mergesort.c) in naive_dealloc folder	Frequency: 24
DEBUG: _CALLER_DEALLOC macro on "arr" (LINE:664 FILE: mergesort.c) in naive_dealloc folder	Frequency: 1
DEBUG: _CALLER_DEALLOC macro on "ys" (LINE:396 FILE: mergesort.c) in naive_dealloc folder	Frequency: 1
DEBUG: _CALLER_DEALLOC macro on "lhs" (LINE:89 FILE: mergesort.c) in naive_dealloc folder	Frequency: 24
DEBUG: _CALLER_DEALLOC macro on "ys" (LINE:457 FILE: mergesort.c) in naive_dealloc folder	Frequency: 1
DEBUG: _RESET_DEALLOC macro on "arr" (LINE:657 FILE: mergesort.c) in copy_reduced_dealloc folder	Frequency: 1
DEBUG: _RESET_DEALLOC macro on "ys" (LINE:453 FILE: mergesort.c) in copy_reduced_dealloc folder	Frequency: 1
DEBUG: _RESET_DEALLOC macro on "lhs" (LINE:88 FILE: mergesort.c) in copy_reduced_dealloc folder	Frequency: 24
DEBUG: _RESET_DEALLOC macro on "ys" (LINE:393 FILE: mergesort.c) in copy_reduced_dealloc folder	Frequency: 1
DEBUG: _RESET_DEALLOC macro on "rhs" (LINE:114 FILE: mergesort.c) in copy_reduced_dealloc folder	Frequency: 24
DEBUG: _RESET_DEALLOC macro on "ys" (LINE:511 FILE: mergesort.c) in copy_reduced_dealloc folder	Frequency: 1
DEBUG: _RESET_DEALLOC macro on "ys" (LINE:571 FILE: mergesort.c) in copy_reduced_dealloc folder	Frequency: 1
DEBUG: _CALLER_DEALLOC macro on "ys" (LINE:231 FILE: bubblesort.c) in naive_dealloc folder	Frequency: 1
DEBUG: _RESET_DEALLOC macro on "ys" (LINE:230 FILE: bubblesort.c) in copy_reduced_dealloc folder	Frequency: 1
DEBUG: _CALLEE_DEALLOC macro on "C" (LINE:620 FILE: MatrixMult.c) in naive_dealloc folder	Frequency: 1
DEBUG: _CALLEE_DEALLOC macro on "A" (LINE:576 FILE: MatrixMult.c) in naive_dealloc folder	Frequency: 1
DEBUG: _CALLEE_DEALLOC macro on "B" (LINE:578 FILE: MatrixMult.c) in naive_dealloc folder	Frequency: 1
DEBUG: _CALLEE_DEALLOC macro on "rows" (LINE:419 FILE: MatrixMult.c) in naive_dealloc folder	Frequency: 2
DEBUG: _CALLEE_DEALLOC macro on "C_data" (LINE:216 FILE: MatrixMult.c) in naive_dealloc folder	Frequency: 1
DEBUG: _RETAIN_DEALLOC macro on "B" (LINE:575 FILE: MatrixMult.c) in copy_reduced_dealloc folder	Frequency: 1
DEBUG: _RETAIN_DEALLOC macro on "C" (LINE:616 FILE: MatrixMult.c) in copy_reduced_dealloc folder	Frequency: 1
DEBUG: _RESET_DEALLOC macro on "C_data" (LINE:216 FILE: MatrixMult.c) in copy_reduced_dealloc folder	Frequency: 1
DEBUG: _RETAIN_DEALLOC macro on "A" (LINE:573 FILE: MatrixMult.c) in copy_reduced_dealloc folder	Frequency: 1
DEBUG: _RESET_DEALLOC macro on "rows" (LINE:418 FILE: MatrixMult.c) in copy_reduced_dealloc folder	Frequency: 2
DEBUG: Memory leaks at "arr"_tmp (LINE:137 FILE: Fibonacci.c) in naive_dealloc folder	Frequency: 1
DEBUG: _CALLER_DEALLOC macro on "ls" (LINE:52 FILE: Fibonacci.c) in naive_dealloc folder	Frequency: 8
DEBUG: _CALLER_DEALLOC macro on "arr" (LINE:137 FILE: Fibonacci.c) in naive_dealloc folder	Frequency: 1
DEBUG: Memory leaks at "ls"_tmp (LINE:52 FILE: Fibonacci.c) in naive_dealloc folder	Frequency: 7
DEBUG: _RESET_DEALLOC macro on "arr" (LINE:135 FILE: Fibonacci.c) in copy_reduced_dealloc folder	Frequency: 1
DEBUG: _RESET_DEALLOC macro on "ls" (LINE:51 FILE: Fibonacci.c) in copy_reduced_dealloc folder	Frequency: 8
DEBUG: _CALLEE_DEALLOC macro on "A" (LINE:675 FILE: MatrixMult2.c) in naive_dealloc folder	Frequency: 1
DEBUG: _CALLEE_DEALLOC macro on "data" (LINE:145 FILE: MatrixMult2.c) in naive_dealloc folder	Frequency: 2
DEBUG: _CALLEE_DEALLOC macro on "data" (LINE:442 FILE: MatrixMult2.c) in naive_dealloc folder	Frequency: 1
DEBUG: _CALLEE_DEALLOC macro on "B" (LINE:677 FILE: MatrixMult2.c) in naive_dealloc folder	Frequency: 1
DEBUG: _CALLEE_DEALLOC macro on "C" (LINE:726 FILE: MatrixMult2.c) in naive_dealloc folder	Frequency: 1
DEBUG: _RETAIN_DEALLOC macro on "B" (LINE:674 FILE: MatrixMult2.c) in copy_reduced_dealloc folder	Frequency: 1
DEBUG: _RETAIN_DEALLOC macro on "C" (LINE:722 FILE: MatrixMult2.c) in copy_reduced_dealloc folder	Frequency: 1
DEBUG: _RESET_DEALLOC macro on "data" (LINE:145 FILE: MatrixMult2.c) in copy_reduced_dealloc folder	Frequency: 2
DEBUG: _RETAIN_DEALLOC macro on "A" (LINE:672 FILE: MatrixMult2.c) in copy_reduced_dealloc folder	Frequency: 1
DEBUG: _RESET_DEALLOC macro on "data" (LINE:441 FILE: MatrixMult2.c) in copy_reduced_dealloc folder	Frequency: 1
DEBUG: _CALLEE_DEALLOC macro on "A" (LINE:771 FILE: MatrixMult3.c) in naive_dealloc folder	Frequency: 1
DEBUG: _CALLEE_DEALLOC macro on "data" (LINE:536 FILE: MatrixMult3.c) in naive_dealloc folder	Frequency: 1
DEBUG: _CALLEE_DEALLOC macro on "C" (LINE:822 FILE: MatrixMult3.c) in naive_dealloc folder	Frequency: 1
DEBUG: _CALLEE_DEALLOC macro on "B" (LINE:773 FILE: MatrixMult3.c) in naive_dealloc folder	Frequency: 1
DEBUG: _CALLEE_DEALLOC macro on "data" (LINE:145 FILE: MatrixMult3.c) in naive_dealloc folder	Frequency: 2
DEBUG: _RESET_DEALLOC macro on "data" (LINE:145 FILE: MatrixMult3.c) in copy_reduced_dealloc folder	Frequency: 2
DEBUG: _RETAIN_DEALLOC macro on "C" (LINE:818 FILE: MatrixMult3.c) in copy_reduced_dealloc folder	Frequency: 1
DEBUG: _RETAIN_DEALLOC macro on "B" (LINE:770 FILE: MatrixMult3.c) in copy_reduced_dealloc folder	Frequency: 1
DEBUG: _RETAIN_DEALLOC macro on "A" (LINE:768 FILE: MatrixMult3.c) in copy_reduced_dealloc folder	Frequency: 1
DEBUG: _RESET_DEALLOC macro on "data" (LINE:535 FILE: MatrixMult3.c) in copy_reduced_dealloc folder	Frequency: 1
DEBUG: _CALLEE_DEALLOC macro on "gcds" (LINE:218 FILE: gcd.c) in naive_dealloc folder	Frequency: 100
DEBUG: _RETAIN_DEALLOC macro on "gcds" (LINE:217 FILE: gcd.c) in copy_reduced_dealloc folder	Frequency: 100
DEBUG: _CALLEE_DEALLOC macro on "moves" (LINE:571 FILE: CoinGame.c) in naive_dealloc folder	Frequency: 1
DEBUG: _CALLER_DEALLOC macro on "moves" (LINE:559 FILE: CoinGame.c) in naive_dealloc folder	Frequency: 1
DEBUG: _RETAIN_DEALLOC macro on "moves" (LINE:569 FILE: CoinGame.c) in copy_reduced_dealloc folder	Frequency: 1
DEBUG: _RESET_DEALLOC macro on "moves" (LINE:558 FILE: CoinGame.c) in copy_reduced_dealloc folder	Frequency: 1
DEBUG: _CALLER_DEALLOC macro on "moves" (LINE:256 FILE: CoinGame1.c) in naive_dealloc folder	Frequency: 1
DEBUG: _RESET_DEALLOC macro on "moves" (LINE:255 FILE: CoinGame1.c) in copy_reduced_dealloc folder	Frequency: 1
DEBUG: _CALLER_DEALLOC macro on "moves" (LINE:359 FILE: CoinGame2.c) in naive_dealloc folder	Frequency: 1
DEBUG: _RESET_DEALLOC macro on "moves" (LINE:358 FILE: CoinGame2.c) in copy_reduced_dealloc folder	Frequency: 1
DEBUG: _CALLER_DEALLOC macro on "moves" (LINE:334 FILE: CoinGame3.c) in naive_dealloc folder	Frequency: 1
DEBUG: _RESET_DEALLOC macro on "moves" (LINE:333 FILE: CoinGame3.c) in copy_reduced_dealloc folder	Frequency: 1
DEBUG: _CALLER_DEALLOC macro on "moves" (LINE:507 FILE: CoinGame4.c) in naive_dealloc folder	Frequency: 55
DEBUG: _CALLER_DEALLOC macro on "moves" (LINE:592 FILE: CoinGame4.c) in naive_dealloc folder	Frequency: 1
DEBUG: Memory leaks at "moves"_tmp (LINE:592 FILE: CoinGame4.c) in naive_dealloc folder	Frequency: 1
DEBUG: _CALLEE_DEALLOC macro on "moves" (LINE:604 FILE: CoinGame4.c) in naive_dealloc folder	Frequency: 1
DEBUG: _RETAIN_DEALLOC macro on "moves" (LINE:601 FILE: CoinGame4.c) in copy_reduced_dealloc folder	Frequency: 1
DEBUG: _RESET_DEALLOC macro on "moves" (LINE:590 FILE: CoinGame4.c) in copy_reduced_dealloc folder	Frequency: 1
DEBUG: _RESET_DEALLOC macro on "moves" (LINE:506 FILE: CoinGame4.c) in copy_reduced_dealloc folder	Frequency: 55
DEBUG: _CALLEE_DEALLOC macro on "p" (LINE:315 FILE: nqueens.c) in naive_dealloc folder	Frequency: 46752
DEBUG: Memory leaks at "nq"_tmp (LINE:374 FILE: nqueens.c) in naive_dealloc folder	Frequency: 1320
DEBUG: _CALLER_DEALLOC macro on "nq" (LINE:374 FILE: nqueens.c) in naive_dealloc folder	Frequency: 2056
DEBUG: _CALLER_DEALLOC macro on "nq" (LINE:497 FILE: nqueens.c) in naive_dealloc folder	Frequency: 1
DEBUG: _CALLEE_DEALLOC macro on "queens" (LINE:482 FILE: nqueens.c) in naive_dealloc folder	Frequency: 1
DEBUG: Memory leaks at "nq"_tmp (LINE:497 FILE: nqueens.c) in naive_dealloc folder	Frequency: 1
DEBUG: _RESET_DEALLOC macro on "nq" (LINE:373 FILE: nqueens.c) in copy_reduced_dealloc folder	Frequency: 2056
DEBUG: _RETAIN_DEALLOC macro on "p" (LINE:315 FILE: nqueens.c) in copy_reduced_dealloc folder	Frequency: 46752
DEBUG: _RESET_DEALLOC macro on "queens" (LINE:480 FILE: nqueens.c) in copy_reduced_dealloc folder	Frequency: 1
DEBUG: _RESET_DEALLOC macro on "nq" (LINE:494 FILE: nqueens.c) in copy_reduced_dealloc folder	Frequency: 1
DEBUG: _CALLEE_DEALLOC macro on "queens" (LINE:377 FILE: nqueens2.c) in naive_dealloc folder	Frequency: 1
DEBUG: _CALLEE_DEALLOC macro on "p" (LINE:228 FILE: nqueens2.c) in naive_dealloc folder	Frequency: 46752
DEBUG: _CALLEE_DEALLOC macro on "queens" (LINE:286 FILE: nqueens2.c) in naive_dealloc folder	Frequency: 2056
DEBUG: _CALLEE_DEALLOC macro on "queens" (LINE:376 FILE: nqueens2.c) in copy_reduced_dealloc folder	Frequency: 1
DEBUG: _RETAIN_DEALLOC macro on "p" (LINE:227 FILE: nqueens2.c) in copy_reduced_dealloc folder	Frequency: 46752
DEBUG: _CALLEE_DEALLOC macro on "queens" (LINE:285 FILE: nqueens2.c) in copy_reduced_dealloc folder	Frequency: 2056
DEBUG: _CALLEE_DEALLOC macro on "b" (LINE:171 FILE: FunctionCall1.c) in naive_dealloc folder	Frequency: 1
DEBUG: _CALLEE_DEALLOC macro on "a" (LINE:104 FILE: FunctionCall1.c) in naive_dealloc folder	Frequency: 1
DEBUG: _CALLER_DEALLOC macro on "b" (LINE:170 FILE: FunctionCall1.c) in copy_reduced_dealloc folder	Frequency: 1
DEBUG: _RESET_DEALLOC macro on "a" (LINE:103 FILE: FunctionCall1.c) in copy_reduced_dealloc folder	Frequency: 1
DEBUG: _CALLER_DEALLOC macro on "a" (LINE:123 FILE: FunctionCall2.c) in naive_dealloc folder	Frequency: 1
DEBUG: Memory leaks at "a"_tmp (LINE:123 FILE: FunctionCall2.c) in naive_dealloc folder	Frequency: 1
DEBUG: _CALLER_DEALLOC macro on "b" (LINE:192 FILE: FunctionCall2.c) in naive_dealloc folder	Frequency: 1
DEBUG: _CALLER_DEALLOC macro on "b" (LINE:191 FILE: FunctionCall2.c) in copy_reduced_dealloc folder	Frequency: 1
DEBUG: _RESET_DEALLOC macro on "a" (LINE:122 FILE: FunctionCall2.c) in copy_reduced_dealloc folder	Frequency: 1
DEBUG: _CALLEE_DEALLOC macro on "b" (LINE:163 FILE: FunctionCall3.c) in naive_dealloc folder	Frequency: 1
DEBUG: _CALLEE_DEALLOC macro on "a" (LINE:96 FILE: FunctionCall3.c) in naive_dealloc folder	Frequency: 1
DEBUG: _RESET_DEALLOC macro on "a" (LINE:95 FILE: FunctionCall3.c) in copy_reduced_dealloc folder	Frequency: 1
DEBUG: _CALLER_DEALLOC macro on "b" (LINE:162 FILE: FunctionCall3.c) in copy_reduced_dealloc folder	Frequency: 1
DEBUG: _CALLEE_DEALLOC macro on "a" (LINE:155 FILE: FunctionCall4.c) in naive_dealloc folder	Frequency: 1
DEBUG: _CALLEE_DEALLOC macro on "b" (LINE:224 FILE: FunctionCall4.c) in naive_dealloc folder	Frequency: 1
DEBUG: _CALLER_DEALLOC macro on "b" (LINE:223 FILE: FunctionCall4.c) in copy_reduced_dealloc folder	Frequency: 1
DEBUG: Memory leaks at "b"_tmp (LINE:223 FILE: FunctionCall4.c) in copy_reduced_dealloc folder	Frequency: 1
DEBUG: _RESET_DEALLOC macro on "a" (LINE:154 FILE: FunctionCall4.c) in copy_reduced_dealloc folder	Frequency: 1
DEBUG: _CALLEE_DEALLOC macro on "pixels" (LINE:309 FILE: SobelEdgeDetect.c) in naive_dealloc folder	Frequency: 64
DEBUG: _CALLEE_DEALLOC macro on "h_sobel" (LINE:323 FILE: SobelEdgeDetect.c) in naive_dealloc folder	Frequency: 64
DEBUG: _CALLEE_DEALLOC macro on "pixels" (LINE:657 FILE: SobelEdgeDetect.c) in naive_dealloc folder	Frequency: 1
DEBUG: _CALLEE_DEALLOC macro on "newPixels" (LINE:673 FILE: SobelEdgeDetect.c) in naive_dealloc folder	Frequency: 1
DEBUG: _CALLEE_DEALLOC macro on "pixels" (LINE:636 FILE: SobelEdgeDetect.c) in naive_dealloc folder	Frequency: 1
DEBUG: _CALLEE_DEALLOC macro on "v_sobel" (LINE:311 FILE: SobelEdgeDetect.c) in naive_dealloc folder	Frequency: 64
DEBUG: _CALLEE_DEALLOC macro on "pixels" (LINE:321 FILE: SobelEdgeDetect.c) in naive_dealloc folder	Frequency: 64
DEBUG: _RETAIN_DEALLOC macro on "pixels" (LINE:317 FILE: SobelEdgeDetect.c) in copy_reduced_dealloc folder	Frequency: 64
DEBUG: _RETAIN_DEALLOC macro on "newPixels" (LINE:666 FILE: SobelEdgeDetect.c) in copy_reduced_dealloc folder	Frequency: 1
DEBUG: _RETAIN_DEALLOC macro on "pixels" (LINE:307 FILE: SobelEdgeDetect.c) in copy_reduced_dealloc folder	Frequency: 64
DEBUG: _RETAIN_DEALLOC macro on "v_sobel" (LINE:309 FILE: SobelEdgeDetect.c) in copy_reduced_dealloc folder	Frequency: 64
DEBUG: _RETAIN_DEALLOC macro on "pixels" (LINE:631 FILE: SobelEdgeDetect.c) in copy_reduced_dealloc folder	Frequency: 1
DEBUG: _RETAIN_DEALLOC macro on "h_sobel" (LINE:319 FILE: SobelEdgeDetect.c) in copy_reduced_dealloc folder	Frequency: 64
DEBUG: _RETAIN_DEALLOC macro on "pixels" (LINE:651 FILE: SobelEdgeDetect.c) in copy_reduced_dealloc folder	Frequency: 1
DEBUG: _CALLEE_DEALLOC macro on "pixels" (LINE:629 FILE: SobelEdgeDetect1.c) in naive_dealloc folder	Frequency: 1
DEBUG: _CALLEE_DEALLOC macro on "pixels" (LINE:321 FILE: SobelEdgeDetect1.c) in naive_dealloc folder	Frequency: 64
DEBUG: _CALLEE_DEALLOC macro on "h_sobel" (LINE:323 FILE: SobelEdgeDetect1.c) in naive_dealloc folder	Frequency: 64
DEBUG: _CALLEE_DEALLOC macro on "pixels" (LINE:309 FILE: SobelEdgeDetect1.c) in naive_dealloc folder	Frequency: 64
DEBUG: _CALLEE_DEALLOC macro on "newPixels" (LINE:645 FILE: SobelEdgeDetect1.c) in naive_dealloc folder	Frequency: 1
DEBUG: _CALLEE_DEALLOC macro on "pixels" (LINE:608 FILE: SobelEdgeDetect1.c) in naive_dealloc folder	Frequency: 1
DEBUG: _CALLEE_DEALLOC macro on "v_sobel" (LINE:311 FILE: SobelEdgeDetect1.c) in naive_dealloc folder	Frequency: 64
DEBUG: _RETAIN_DEALLOC macro on "pixels" (LINE:317 FILE: SobelEdgeDetect1.c) in copy_reduced_dealloc folder	Frequency: 64
DEBUG: _RETAIN_DEALLOC macro on "pixels" (LINE:623 FILE: SobelEdgeDetect1.c) in copy_reduced_dealloc folder	Frequency: 1
DEBUG: _RETAIN_DEALLOC macro on "v_sobel" (LINE:309 FILE: SobelEdgeDetect1.c) in copy_reduced_dealloc folder	Frequency: 64
DEBUG: _RETAIN_DEALLOC macro on "newPixels" (LINE:638 FILE: SobelEdgeDetect1.c) in copy_reduced_dealloc folder	Frequency: 1
DEBUG: _RETAIN_DEALLOC macro on "pixels" (LINE:603 FILE: SobelEdgeDetect1.c) in copy_reduced_dealloc folder	Frequency: 1
DEBUG: _RETAIN_DEALLOC macro on "h_sobel" (LINE:319 FILE: SobelEdgeDetect1.c) in copy_reduced_dealloc folder	Frequency: 64
DEBUG: _RETAIN_DEALLOC macro on "pixels" (LINE:307 FILE: SobelEdgeDetect1.c) in copy_reduced_dealloc folder	Frequency: 64
DEBUG: _CALLEE_DEALLOC macro on "h_sobel" (LINE:420 FILE: SobelEdgeDetect2.c) in naive_dealloc folder	Frequency: 64
DEBUG: _CALLEE_DEALLOC macro on "v_sobel" (LINE:408 FILE: SobelEdgeDetect2.c) in naive_dealloc folder	Frequency: 64
DEBUG: _CALLEE_DEALLOC macro on "pixels" (LINE:728 FILE: SobelEdgeDetect2.c) in naive_dealloc folder	Frequency: 1
DEBUG: _CALLEE_DEALLOC macro on "input" (LINE:418 FILE: SobelEdgeDetect2.c) in naive_dealloc folder	Frequency: 64
DEBUG: _CALLEE_DEALLOC macro on "newPixels" (LINE:478 FILE: SobelEdgeDetect2.c) in naive_dealloc folder	Frequency: 1
DEBUG: _CALLEE_DEALLOC macro on "output" (LINE:778 FILE: SobelEdgeDetect2.c) in naive_dealloc folder	Frequency: 1
DEBUG: _CALLEE_DEALLOC macro on "input" (LINE:762 FILE: SobelEdgeDetect2.c) in naive_dealloc folder	Frequency: 1
DEBUG: _CALLEE_DEALLOC macro on "input" (LINE:741 FILE: SobelEdgeDetect2.c) in naive_dealloc folder	Frequency: 1
DEBUG: _CALLEE_DEALLOC macro on "input" (LINE:406 FILE: SobelEdgeDetect2.c) in naive_dealloc folder	Frequency: 64
DEBUG: _RETAIN_DEALLOC macro on "input" (LINE:735 FILE: SobelEdgeDetect2.c) in copy_reduced_dealloc folder	Frequency: 1
DEBUG: _RETAIN_DEALLOC macro on "output" (LINE:770 FILE: SobelEdgeDetect2.c) in copy_reduced_dealloc folder	Frequency: 1
DEBUG: _RETAIN_DEALLOC macro on "input" (LINE:755 FILE: SobelEdgeDetect2.c) in copy_reduced_dealloc folder	Frequency: 1
DEBUG: _RESET_DEALLOC macro on "pixels" (LINE:723 FILE: SobelEdgeDetect2.c) in copy_reduced_dealloc folder	Frequency: 1
DEBUG: _RETAIN_DEALLOC macro on "input" (LINE:415 FILE: SobelEdgeDetect2.c) in copy_reduced_dealloc folder	Frequency: 64
DEBUG: _RETAIN_DEALLOC macro on "v_sobel" (LINE:407 FILE: SobelEdgeDetect2.c) in copy_reduced_dealloc folder	Frequency: 64
DEBUG: _RETAIN_DEALLOC macro on "h_sobel" (LINE:417 FILE: SobelEdgeDetect2.c) in copy_reduced_dealloc folder	Frequency: 64
DEBUG: _RESET_DEALLOC macro on "newPixels" (LINE:474 FILE: SobelEdgeDetect2.c) in copy_reduced_dealloc folder	Frequency: 1
DEBUG: _RETAIN_DEALLOC macro on "input" (LINE:405 FILE: SobelEdgeDetect2.c) in copy_reduced_dealloc folder	Frequency: 64
