Test case 1	Live_a|Live_b	ReadOnly_a|ReadOnly_b	AlwaysReturn_a
Test case 2	Live_a|Live_b	ReadOnly_a|ReadOnly_b	AlwaysReturn_b
Test case 3	Live_a|Live_b	ReadOnly_a|ReadOnly_b	MaybeReturn_a|MaybeReturn_b
Test case 4	Live_a|Live_b	ReadOnly_a|ReadOnly_b	MaybeReturn_a|NeverReturn_b
Test case 5	Live_a|Live_b	ReadOnly_a|ReadOnly_b	NeverReturn_a|MaybeReturn_b
Test case 6	Live_a|Live_b	ReadOnly_a|ReadOnly_b	NeverReturn_a|NeverReturn_b
Test case 7	Live_a|Live_b	ReadOnly_a|ReadWrite_b	AlwaysReturn_a
Test case 8	Live_a|Live_b	ReadOnly_a|ReadWrite_b	AlwaysReturn_b
Test case 9	Live_a|Live_b	ReadOnly_a|ReadWrite_b	MaybeReturn_a|MaybeReturn_b
Test case 10	Live_a|Live_b	ReadOnly_a|ReadWrite_b	MaybeReturn_a|NeverReturn_b
Test case 11	Live_a|Live_b	ReadOnly_a|ReadWrite_b	NeverReturn_a|MaybeReturn_b
Test case 12	Live_a|Live_b	ReadOnly_a|ReadWrite_b	NeverReturn_a|NeverReturn_b
Test case 13	Live_a|Live_b	ReadWrite_a|ReadOnly_b	AlwaysReturn_a
Test case 14	Live_a|Live_b	ReadWrite_a|ReadOnly_b	AlwaysReturn_b
Test case 15	Live_a|Live_b	ReadWrite_a|ReadOnly_b	MaybeReturn_a|MaybeReturn_b
Test case 16	Live_a|Live_b	ReadWrite_a|ReadOnly_b	MaybeReturn_a|NeverReturn_b
Test case 17	Live_a|Live_b	ReadWrite_a|ReadOnly_b	NeverReturn_a|MaybeReturn_b
Test case 18	Live_a|Live_b	ReadWrite_a|ReadOnly_b	NeverReturn_a|NeverReturn_b
Test case 19	Live_a|Live_b	ReadWrite_a|ReadWrite_b	AlwaysReturn_a
Test case 20	Live_a|Live_b	ReadWrite_a|ReadWrite_b	AlwaysReturn_b
Test case 21	Live_a|Live_b	ReadWrite_a|ReadWrite_b	MaybeReturn_a|MaybeReturn_b
Test case 22	Live_a|Live_b	ReadWrite_a|ReadWrite_b	MaybeReturn_a|NeverReturn_b
Test case 23	Live_a|Live_b	ReadWrite_a|ReadWrite_b	NeverReturn_a|MaybeReturn_b
Test case 24	Live_a|Live_b	ReadWrite_a|ReadWrite_b	NeverReturn_a|NeverReturn_b
Test case 25	Live_a|NotLive_b	ReadOnly_a|ReadOnly_b	AlwaysReturn_a
Test case 26	Live_a|NotLive_b	ReadOnly_a|ReadOnly_b	AlwaysReturn_b
Test case 27	Live_a|NotLive_b	ReadOnly_a|ReadOnly_b	MaybeReturn_a|MaybeReturn_b
Test case 28	Live_a|NotLive_b	ReadOnly_a|ReadOnly_b	MaybeReturn_a|NeverReturn_b
Test case 29	Live_a|NotLive_b	ReadOnly_a|ReadOnly_b	NeverReturn_a|MaybeReturn_b
Test case 30	Live_a|NotLive_b	ReadOnly_a|ReadOnly_b	NeverReturn_a|NeverReturn_b
Test case 31	Live_a|NotLive_b	ReadOnly_a|ReadWrite_b	AlwaysReturn_a
Test case 32	Live_a|NotLive_b	ReadOnly_a|ReadWrite_b	AlwaysReturn_b
Test case 33	Live_a|NotLive_b	ReadOnly_a|ReadWrite_b	MaybeReturn_a|MaybeReturn_b
Test case 34	Live_a|NotLive_b	ReadOnly_a|ReadWrite_b	MaybeReturn_a|NeverReturn_b
Test case 35	Live_a|NotLive_b	ReadOnly_a|ReadWrite_b	NeverReturn_a|MaybeReturn_b
Test case 36	Live_a|NotLive_b	ReadOnly_a|ReadWrite_b	NeverReturn_a|NeverReturn_b
Test case 37	Live_a|NotLive_b	ReadWrite_a|ReadOnly_b	AlwaysReturn_a
Test case 38	Live_a|NotLive_b	ReadWrite_a|ReadOnly_b	AlwaysReturn_b
Test case 39	Live_a|NotLive_b	ReadWrite_a|ReadOnly_b	MaybeReturn_a|MaybeReturn_b
Test case 40	Live_a|NotLive_b	ReadWrite_a|ReadOnly_b	MaybeReturn_a|NeverReturn_b
Test case 41	Live_a|NotLive_b	ReadWrite_a|ReadOnly_b	NeverReturn_a|MaybeReturn_b
Test case 42	Live_a|NotLive_b	ReadWrite_a|ReadOnly_b	NeverReturn_a|NeverReturn_b
Test case 43	Live_a|NotLive_b	ReadWrite_a|ReadWrite_b	AlwaysReturn_a
Test case 44	Live_a|NotLive_b	ReadWrite_a|ReadWrite_b	AlwaysReturn_b
Test case 45	Live_a|NotLive_b	ReadWrite_a|ReadWrite_b	MaybeReturn_a|MaybeReturn_b
Test case 46	Live_a|NotLive_b	ReadWrite_a|ReadWrite_b	MaybeReturn_a|NeverReturn_b
Test case 47	Live_a|NotLive_b	ReadWrite_a|ReadWrite_b	NeverReturn_a|MaybeReturn_b
Test case 48	Live_a|NotLive_b	ReadWrite_a|ReadWrite_b	NeverReturn_a|NeverReturn_b
Test case 49	NotLive_a|Live_b	ReadOnly_a|ReadOnly_b	AlwaysReturn_a
Test case 50	NotLive_a|Live_b	ReadOnly_a|ReadOnly_b	AlwaysReturn_b
Test case 51	NotLive_a|Live_b	ReadOnly_a|ReadOnly_b	MaybeReturn_a|MaybeReturn_b
Test case 52	NotLive_a|Live_b	ReadOnly_a|ReadOnly_b	MaybeReturn_a|NeverReturn_b
Test case 53	NotLive_a|Live_b	ReadOnly_a|ReadOnly_b	NeverReturn_a|MaybeReturn_b
Test case 54	NotLive_a|Live_b	ReadOnly_a|ReadOnly_b	NeverReturn_a|NeverReturn_b
Test case 55	NotLive_a|Live_b	ReadOnly_a|ReadWrite_b	AlwaysReturn_a
Test case 56	NotLive_a|Live_b	ReadOnly_a|ReadWrite_b	AlwaysReturn_b
Test case 57	NotLive_a|Live_b	ReadOnly_a|ReadWrite_b	MaybeReturn_a|MaybeReturn_b
Test case 58	NotLive_a|Live_b	ReadOnly_a|ReadWrite_b	MaybeReturn_a|NeverReturn_b
Test case 59	NotLive_a|Live_b	ReadOnly_a|ReadWrite_b	NeverReturn_a|MaybeReturn_b
Test case 60	NotLive_a|Live_b	ReadOnly_a|ReadWrite_b	NeverReturn_a|NeverReturn_b
Test case 61	NotLive_a|Live_b	ReadWrite_a|ReadOnly_b	AlwaysReturn_a
Test case 62	NotLive_a|Live_b	ReadWrite_a|ReadOnly_b	AlwaysReturn_b
Test case 63	NotLive_a|Live_b	ReadWrite_a|ReadOnly_b	MaybeReturn_a|MaybeReturn_b
Test case 64	NotLive_a|Live_b	ReadWrite_a|ReadOnly_b	MaybeReturn_a|NeverReturn_b
Test case 65	NotLive_a|Live_b	ReadWrite_a|ReadOnly_b	NeverReturn_a|MaybeReturn_b
Test case 66	NotLive_a|Live_b	ReadWrite_a|ReadOnly_b	NeverReturn_a|NeverReturn_b
Test case 67	NotLive_a|Live_b	ReadWrite_a|ReadWrite_b	AlwaysReturn_a
Test case 68	NotLive_a|Live_b	ReadWrite_a|ReadWrite_b	AlwaysReturn_b
Test case 69	NotLive_a|Live_b	ReadWrite_a|ReadWrite_b	MaybeReturn_a|MaybeReturn_b
Test case 70	NotLive_a|Live_b	ReadWrite_a|ReadWrite_b	MaybeReturn_a|NeverReturn_b
Test case 71	NotLive_a|Live_b	ReadWrite_a|ReadWrite_b	NeverReturn_a|MaybeReturn_b
Test case 72	NotLive_a|Live_b	ReadWrite_a|ReadWrite_b	NeverReturn_a|NeverReturn_b
Test case 73	NotLive_a|NotLive_b	ReadOnly_a|ReadOnly_b	AlwaysReturn_a
Test case 74	NotLive_a|NotLive_b	ReadOnly_a|ReadOnly_b	AlwaysReturn_b
Test case 75	NotLive_a|NotLive_b	ReadOnly_a|ReadOnly_b	MaybeReturn_a|MaybeReturn_b
Test case 76	NotLive_a|NotLive_b	ReadOnly_a|ReadOnly_b	MaybeReturn_a|NeverReturn_b
Test case 77	NotLive_a|NotLive_b	ReadOnly_a|ReadOnly_b	NeverReturn_a|MaybeReturn_b
Test case 78	NotLive_a|NotLive_b	ReadOnly_a|ReadOnly_b	NeverReturn_a|NeverReturn_b
Test case 79	NotLive_a|NotLive_b	ReadOnly_a|ReadWrite_b	AlwaysReturn_a
Test case 80	NotLive_a|NotLive_b	ReadOnly_a|ReadWrite_b	AlwaysReturn_b
Test case 81	NotLive_a|NotLive_b	ReadOnly_a|ReadWrite_b	MaybeReturn_a|MaybeReturn_b
Test case 82	NotLive_a|NotLive_b	ReadOnly_a|ReadWrite_b	MaybeReturn_a|NeverReturn_b
Test case 83	NotLive_a|NotLive_b	ReadOnly_a|ReadWrite_b	NeverReturn_a|MaybeReturn_b
Test case 84	NotLive_a|NotLive_b	ReadOnly_a|ReadWrite_b	NeverReturn_a|NeverReturn_b
Test case 85	NotLive_a|NotLive_b	ReadWrite_a|ReadOnly_b	AlwaysReturn_a
Test case 86	NotLive_a|NotLive_b	ReadWrite_a|ReadOnly_b	AlwaysReturn_b
Test case 87	NotLive_a|NotLive_b	ReadWrite_a|ReadOnly_b	MaybeReturn_a|MaybeReturn_b
Test case 88	NotLive_a|NotLive_b	ReadWrite_a|ReadOnly_b	MaybeReturn_a|NeverReturn_b
Test case 89	NotLive_a|NotLive_b	ReadWrite_a|ReadOnly_b	NeverReturn_a|MaybeReturn_b
Test case 90	NotLive_a|NotLive_b	ReadWrite_a|ReadOnly_b	NeverReturn_a|NeverReturn_b
Test case 91	NotLive_a|NotLive_b	ReadWrite_a|ReadWrite_b	AlwaysReturn_a
Test case 92	NotLive_a|NotLive_b	ReadWrite_a|ReadWrite_b	AlwaysReturn_b
Test case 93	NotLive_a|NotLive_b	ReadWrite_a|ReadWrite_b	MaybeReturn_a|MaybeReturn_b
Test case 94	NotLive_a|NotLive_b	ReadWrite_a|ReadWrite_b	MaybeReturn_a|NeverReturn_b
Test case 95	NotLive_a|NotLive_b	ReadWrite_a|ReadWrite_b	NeverReturn_a|MaybeReturn_b
Test case 96	NotLive_a|NotLive_b	ReadWrite_a|ReadWrite_b	NeverReturn_a|NeverReturn_b
