Test case 1	Live_a|Live_b|Live_c	ReadOnly_a|ReadOnly_b|ReadOnly_c	AlwaysReturn_a
Test case 2	Live_a|Live_b|Live_c	ReadOnly_a|ReadOnly_b|ReadOnly_c	AlwaysReturn_b
Test case 3	Live_a|Live_b|Live_c	ReadOnly_a|ReadOnly_b|ReadOnly_c	AlwaysReturn_c
Test case 4	Live_a|Live_b|Live_c	ReadOnly_a|ReadOnly_b|ReadOnly_c	MaybeReturn_a|MaybeReturn_b|MaybeReturn_c
Test case 5	Live_a|Live_b|Live_c	ReadOnly_a|ReadOnly_b|ReadOnly_c	MaybeReturn_a|MaybeReturn_b|NeverReturn_c
Test case 6	Live_a|Live_b|Live_c	ReadOnly_a|ReadOnly_b|ReadOnly_c	MaybeReturn_a|NeverReturn_b|MaybeReturn_c
Test case 7	Live_a|Live_b|Live_c	ReadOnly_a|ReadOnly_b|ReadOnly_c	MaybeReturn_a|NeverReturn_b|NeverReturn_c
Test case 8	Live_a|Live_b|Live_c	ReadOnly_a|ReadOnly_b|ReadOnly_c	NeverReturn_a|MaybeReturn_b|MaybeReturn_c
Test case 9	Live_a|Live_b|Live_c	ReadOnly_a|ReadOnly_b|ReadOnly_c	NeverReturn_a|MaybeReturn_b|NeverReturn_c
Test case 10	Live_a|Live_b|Live_c	ReadOnly_a|ReadOnly_b|ReadOnly_c	NeverReturn_a|NeverReturn_b|MaybeReturn_c
Test case 11	Live_a|Live_b|Live_c	ReadOnly_a|ReadOnly_b|ReadOnly_c	NeverReturn_a|NeverReturn_b|NeverReturn_c
Test case 12	Live_a|Live_b|Live_c	ReadOnly_a|ReadOnly_b|ReadWrite_c	AlwaysReturn_a
Test case 13	Live_a|Live_b|Live_c	ReadOnly_a|ReadOnly_b|ReadWrite_c	AlwaysReturn_b
Test case 14	Live_a|Live_b|Live_c	ReadOnly_a|ReadOnly_b|ReadWrite_c	AlwaysReturn_c
Test case 15	Live_a|Live_b|Live_c	ReadOnly_a|ReadOnly_b|ReadWrite_c	MaybeReturn_a|MaybeReturn_b|MaybeReturn_c
Test case 16	Live_a|Live_b|Live_c	ReadOnly_a|ReadOnly_b|ReadWrite_c	MaybeReturn_a|MaybeReturn_b|NeverReturn_c
Test case 17	Live_a|Live_b|Live_c	ReadOnly_a|ReadOnly_b|ReadWrite_c	MaybeReturn_a|NeverReturn_b|MaybeReturn_c
Test case 18	Live_a|Live_b|Live_c	ReadOnly_a|ReadOnly_b|ReadWrite_c	MaybeReturn_a|NeverReturn_b|NeverReturn_c
Test case 19	Live_a|Live_b|Live_c	ReadOnly_a|ReadOnly_b|ReadWrite_c	NeverReturn_a|MaybeReturn_b|MaybeReturn_c
Test case 20	Live_a|Live_b|Live_c	ReadOnly_a|ReadOnly_b|ReadWrite_c	NeverReturn_a|MaybeReturn_b|NeverReturn_c
Test case 21	Live_a|Live_b|Live_c	ReadOnly_a|ReadOnly_b|ReadWrite_c	NeverReturn_a|NeverReturn_b|MaybeReturn_c
Test case 22	Live_a|Live_b|Live_c	ReadOnly_a|ReadOnly_b|ReadWrite_c	NeverReturn_a|NeverReturn_b|NeverReturn_c
Test case 23	Live_a|Live_b|Live_c	ReadOnly_a|ReadWrite_b|ReadOnly_c	AlwaysReturn_a
Test case 24	Live_a|Live_b|Live_c	ReadOnly_a|ReadWrite_b|ReadOnly_c	AlwaysReturn_b
Test case 25	Live_a|Live_b|Live_c	ReadOnly_a|ReadWrite_b|ReadOnly_c	AlwaysReturn_c
Test case 26	Live_a|Live_b|Live_c	ReadOnly_a|ReadWrite_b|ReadOnly_c	MaybeReturn_a|MaybeReturn_b|MaybeReturn_c
Test case 27	Live_a|Live_b|Live_c	ReadOnly_a|ReadWrite_b|ReadOnly_c	MaybeReturn_a|MaybeReturn_b|NeverReturn_c
Test case 28	Live_a|Live_b|Live_c	ReadOnly_a|ReadWrite_b|ReadOnly_c	MaybeReturn_a|NeverReturn_b|MaybeReturn_c
Test case 29	Live_a|Live_b|Live_c	ReadOnly_a|ReadWrite_b|ReadOnly_c	MaybeReturn_a|NeverReturn_b|NeverReturn_c
Test case 30	Live_a|Live_b|Live_c	ReadOnly_a|ReadWrite_b|ReadOnly_c	NeverReturn_a|MaybeReturn_b|MaybeReturn_c
Test case 31	Live_a|Live_b|Live_c	ReadOnly_a|ReadWrite_b|ReadOnly_c	NeverReturn_a|MaybeReturn_b|NeverReturn_c
Test case 32	Live_a|Live_b|Live_c	ReadOnly_a|ReadWrite_b|ReadOnly_c	NeverReturn_a|NeverReturn_b|MaybeReturn_c
Test case 33	Live_a|Live_b|Live_c	ReadOnly_a|ReadWrite_b|ReadOnly_c	NeverReturn_a|NeverReturn_b|NeverReturn_c
Test case 34	Live_a|Live_b|Live_c	ReadOnly_a|ReadWrite_b|ReadWrite_c	AlwaysReturn_a
Test case 35	Live_a|Live_b|Live_c	ReadOnly_a|ReadWrite_b|ReadWrite_c	AlwaysReturn_b
Test case 36	Live_a|Live_b|Live_c	ReadOnly_a|ReadWrite_b|ReadWrite_c	AlwaysReturn_c
Test case 37	Live_a|Live_b|Live_c	ReadOnly_a|ReadWrite_b|ReadWrite_c	MaybeReturn_a|MaybeReturn_b|MaybeReturn_c
Test case 38	Live_a|Live_b|Live_c	ReadOnly_a|ReadWrite_b|ReadWrite_c	MaybeReturn_a|MaybeReturn_b|NeverReturn_c
Test case 39	Live_a|Live_b|Live_c	ReadOnly_a|ReadWrite_b|ReadWrite_c	MaybeReturn_a|NeverReturn_b|MaybeReturn_c
Test case 40	Live_a|Live_b|Live_c	ReadOnly_a|ReadWrite_b|ReadWrite_c	MaybeReturn_a|NeverReturn_b|NeverReturn_c
Test case 41	Live_a|Live_b|Live_c	ReadOnly_a|ReadWrite_b|ReadWrite_c	NeverReturn_a|MaybeReturn_b|MaybeReturn_c
Test case 42	Live_a|Live_b|Live_c	ReadOnly_a|ReadWrite_b|ReadWrite_c	NeverReturn_a|MaybeReturn_b|NeverReturn_c
Test case 43	Live_a|Live_b|Live_c	ReadOnly_a|ReadWrite_b|ReadWrite_c	NeverReturn_a|NeverReturn_b|MaybeReturn_c
Test case 44	Live_a|Live_b|Live_c	ReadOnly_a|ReadWrite_b|ReadWrite_c	NeverReturn_a|NeverReturn_b|NeverReturn_c
Test case 45	Live_a|Live_b|Live_c	ReadWrite_a|ReadOnly_b|ReadOnly_c	AlwaysReturn_a
Test case 46	Live_a|Live_b|Live_c	ReadWrite_a|ReadOnly_b|ReadOnly_c	AlwaysReturn_b
Test case 47	Live_a|Live_b|Live_c	ReadWrite_a|ReadOnly_b|ReadOnly_c	AlwaysReturn_c
Test case 48	Live_a|Live_b|Live_c	ReadWrite_a|ReadOnly_b|ReadOnly_c	MaybeReturn_a|MaybeReturn_b|MaybeReturn_c
Test case 49	Live_a|Live_b|Live_c	ReadWrite_a|ReadOnly_b|ReadOnly_c	MaybeReturn_a|MaybeReturn_b|NeverReturn_c
Test case 50	Live_a|Live_b|Live_c	ReadWrite_a|ReadOnly_b|ReadOnly_c	MaybeReturn_a|NeverReturn_b|MaybeReturn_c
Test case 51	Live_a|Live_b|Live_c	ReadWrite_a|ReadOnly_b|ReadOnly_c	MaybeReturn_a|NeverReturn_b|NeverReturn_c
Test case 52	Live_a|Live_b|Live_c	ReadWrite_a|ReadOnly_b|ReadOnly_c	NeverReturn_a|MaybeReturn_b|MaybeReturn_c
Test case 53	Live_a|Live_b|Live_c	ReadWrite_a|ReadOnly_b|ReadOnly_c	NeverReturn_a|MaybeReturn_b|NeverReturn_c
Test case 54	Live_a|Live_b|Live_c	ReadWrite_a|ReadOnly_b|ReadOnly_c	NeverReturn_a|NeverReturn_b|MaybeReturn_c
Test case 55	Live_a|Live_b|Live_c	ReadWrite_a|ReadOnly_b|ReadOnly_c	NeverReturn_a|NeverReturn_b|NeverReturn_c
Test case 56	Live_a|Live_b|Live_c	ReadWrite_a|ReadOnly_b|ReadWrite_c	AlwaysReturn_a
Test case 57	Live_a|Live_b|Live_c	ReadWrite_a|ReadOnly_b|ReadWrite_c	AlwaysReturn_b
Test case 58	Live_a|Live_b|Live_c	ReadWrite_a|ReadOnly_b|ReadWrite_c	AlwaysReturn_c
Test case 59	Live_a|Live_b|Live_c	ReadWrite_a|ReadOnly_b|ReadWrite_c	MaybeReturn_a|MaybeReturn_b|MaybeReturn_c
Test case 60	Live_a|Live_b|Live_c	ReadWrite_a|ReadOnly_b|ReadWrite_c	MaybeReturn_a|MaybeReturn_b|NeverReturn_c
Test case 61	Live_a|Live_b|Live_c	ReadWrite_a|ReadOnly_b|ReadWrite_c	MaybeReturn_a|NeverReturn_b|MaybeReturn_c
Test case 62	Live_a|Live_b|Live_c	ReadWrite_a|ReadOnly_b|ReadWrite_c	MaybeReturn_a|NeverReturn_b|NeverReturn_c
Test case 63	Live_a|Live_b|Live_c	ReadWrite_a|ReadOnly_b|ReadWrite_c	NeverReturn_a|MaybeReturn_b|MaybeReturn_c
Test case 64	Live_a|Live_b|Live_c	ReadWrite_a|ReadOnly_b|ReadWrite_c	NeverReturn_a|MaybeReturn_b|NeverReturn_c
Test case 65	Live_a|Live_b|Live_c	ReadWrite_a|ReadOnly_b|ReadWrite_c	NeverReturn_a|NeverReturn_b|MaybeReturn_c
Test case 66	Live_a|Live_b|Live_c	ReadWrite_a|ReadOnly_b|ReadWrite_c	NeverReturn_a|NeverReturn_b|NeverReturn_c
Test case 67	Live_a|Live_b|Live_c	ReadWrite_a|ReadWrite_b|ReadOnly_c	AlwaysReturn_a
Test case 68	Live_a|Live_b|Live_c	ReadWrite_a|ReadWrite_b|ReadOnly_c	AlwaysReturn_b
Test case 69	Live_a|Live_b|Live_c	ReadWrite_a|ReadWrite_b|ReadOnly_c	AlwaysReturn_c
Test case 70	Live_a|Live_b|Live_c	ReadWrite_a|ReadWrite_b|ReadOnly_c	MaybeReturn_a|MaybeReturn_b|MaybeReturn_c
Test case 71	Live_a|Live_b|Live_c	ReadWrite_a|ReadWrite_b|ReadOnly_c	MaybeReturn_a|MaybeReturn_b|NeverReturn_c
Test case 72	Live_a|Live_b|Live_c	ReadWrite_a|ReadWrite_b|ReadOnly_c	MaybeReturn_a|NeverReturn_b|MaybeReturn_c
Test case 73	Live_a|Live_b|Live_c	ReadWrite_a|ReadWrite_b|ReadOnly_c	MaybeReturn_a|NeverReturn_b|NeverReturn_c
Test case 74	Live_a|Live_b|Live_c	ReadWrite_a|ReadWrite_b|ReadOnly_c	NeverReturn_a|MaybeReturn_b|MaybeReturn_c
Test case 75	Live_a|Live_b|Live_c	ReadWrite_a|ReadWrite_b|ReadOnly_c	NeverReturn_a|MaybeReturn_b|NeverReturn_c
Test case 76	Live_a|Live_b|Live_c	ReadWrite_a|ReadWrite_b|ReadOnly_c	NeverReturn_a|NeverReturn_b|MaybeReturn_c
Test case 77	Live_a|Live_b|Live_c	ReadWrite_a|ReadWrite_b|ReadOnly_c	NeverReturn_a|NeverReturn_b|NeverReturn_c
Test case 78	Live_a|Live_b|Live_c	ReadWrite_a|ReadWrite_b|ReadWrite_c	AlwaysReturn_a
Test case 79	Live_a|Live_b|Live_c	ReadWrite_a|ReadWrite_b|ReadWrite_c	AlwaysReturn_b
Test case 80	Live_a|Live_b|Live_c	ReadWrite_a|ReadWrite_b|ReadWrite_c	AlwaysReturn_c
Test case 81	Live_a|Live_b|Live_c	ReadWrite_a|ReadWrite_b|ReadWrite_c	MaybeReturn_a|MaybeReturn_b|MaybeReturn_c
Test case 82	Live_a|Live_b|Live_c	ReadWrite_a|ReadWrite_b|ReadWrite_c	MaybeReturn_a|MaybeReturn_b|NeverReturn_c
Test case 83	Live_a|Live_b|Live_c	ReadWrite_a|ReadWrite_b|ReadWrite_c	MaybeReturn_a|NeverReturn_b|MaybeReturn_c
Test case 84	Live_a|Live_b|Live_c	ReadWrite_a|ReadWrite_b|ReadWrite_c	MaybeReturn_a|NeverReturn_b|NeverReturn_c
Test case 85	Live_a|Live_b|Live_c	ReadWrite_a|ReadWrite_b|ReadWrite_c	NeverReturn_a|MaybeReturn_b|MaybeReturn_c
Test case 86	Live_a|Live_b|Live_c	ReadWrite_a|ReadWrite_b|ReadWrite_c	NeverReturn_a|MaybeReturn_b|NeverReturn_c
Test case 87	Live_a|Live_b|Live_c	ReadWrite_a|ReadWrite_b|ReadWrite_c	NeverReturn_a|NeverReturn_b|MaybeReturn_c
Test case 88	Live_a|Live_b|Live_c	ReadWrite_a|ReadWrite_b|ReadWrite_c	NeverReturn_a|NeverReturn_b|NeverReturn_c
Test case 89	Live_a|Live_b|NotLive_c	ReadOnly_a|ReadOnly_b|ReadOnly_c	AlwaysReturn_a
Test case 90	Live_a|Live_b|NotLive_c	ReadOnly_a|ReadOnly_b|ReadOnly_c	AlwaysReturn_b
Test case 91	Live_a|Live_b|NotLive_c	ReadOnly_a|ReadOnly_b|ReadOnly_c	AlwaysReturn_c
Test case 92	Live_a|Live_b|NotLive_c	ReadOnly_a|ReadOnly_b|ReadOnly_c	MaybeReturn_a|MaybeReturn_b|MaybeReturn_c
Test case 93	Live_a|Live_b|NotLive_c	ReadOnly_a|ReadOnly_b|ReadOnly_c	MaybeReturn_a|MaybeReturn_b|NeverReturn_c
Test case 94	Live_a|Live_b|NotLive_c	ReadOnly_a|ReadOnly_b|ReadOnly_c	MaybeReturn_a|NeverReturn_b|MaybeReturn_c
Test case 95	Live_a|Live_b|NotLive_c	ReadOnly_a|ReadOnly_b|ReadOnly_c	MaybeReturn_a|NeverReturn_b|NeverReturn_c
Test case 96	Live_a|Live_b|NotLive_c	ReadOnly_a|ReadOnly_b|ReadOnly_c	NeverReturn_a|MaybeReturn_b|MaybeReturn_c
Test case 97	Live_a|Live_b|NotLive_c	ReadOnly_a|ReadOnly_b|ReadOnly_c	NeverReturn_a|MaybeReturn_b|NeverReturn_c
Test case 98	Live_a|Live_b|NotLive_c	ReadOnly_a|ReadOnly_b|ReadOnly_c	NeverReturn_a|NeverReturn_b|MaybeReturn_c
Test case 99	Live_a|Live_b|NotLive_c	ReadOnly_a|ReadOnly_b|ReadOnly_c	NeverReturn_a|NeverReturn_b|NeverReturn_c
Test case 100	Live_a|Live_b|NotLive_c	ReadOnly_a|ReadOnly_b|ReadWrite_c	AlwaysReturn_a
Test case 101	Live_a|Live_b|NotLive_c	ReadOnly_a|ReadOnly_b|ReadWrite_c	AlwaysReturn_b
Test case 102	Live_a|Live_b|NotLive_c	ReadOnly_a|ReadOnly_b|ReadWrite_c	AlwaysReturn_c
Test case 103	Live_a|Live_b|NotLive_c	ReadOnly_a|ReadOnly_b|ReadWrite_c	MaybeReturn_a|MaybeReturn_b|MaybeReturn_c
Test case 104	Live_a|Live_b|NotLive_c	ReadOnly_a|ReadOnly_b|ReadWrite_c	MaybeReturn_a|MaybeReturn_b|NeverReturn_c
Test case 105	Live_a|Live_b|NotLive_c	ReadOnly_a|ReadOnly_b|ReadWrite_c	MaybeReturn_a|NeverReturn_b|MaybeReturn_c
Test case 106	Live_a|Live_b|NotLive_c	ReadOnly_a|ReadOnly_b|ReadWrite_c	MaybeReturn_a|NeverReturn_b|NeverReturn_c
Test case 107	Live_a|Live_b|NotLive_c	ReadOnly_a|ReadOnly_b|ReadWrite_c	NeverReturn_a|MaybeReturn_b|MaybeReturn_c
Test case 108	Live_a|Live_b|NotLive_c	ReadOnly_a|ReadOnly_b|ReadWrite_c	NeverReturn_a|MaybeReturn_b|NeverReturn_c
Test case 109	Live_a|Live_b|NotLive_c	ReadOnly_a|ReadOnly_b|ReadWrite_c	NeverReturn_a|NeverReturn_b|MaybeReturn_c
Test case 110	Live_a|Live_b|NotLive_c	ReadOnly_a|ReadOnly_b|ReadWrite_c	NeverReturn_a|NeverReturn_b|NeverReturn_c
Test case 111	Live_a|Live_b|NotLive_c	ReadOnly_a|ReadWrite_b|ReadOnly_c	AlwaysReturn_a
Test case 112	Live_a|Live_b|NotLive_c	ReadOnly_a|ReadWrite_b|ReadOnly_c	AlwaysReturn_b
Test case 113	Live_a|Live_b|NotLive_c	ReadOnly_a|ReadWrite_b|ReadOnly_c	AlwaysReturn_c
Test case 114	Live_a|Live_b|NotLive_c	ReadOnly_a|ReadWrite_b|ReadOnly_c	MaybeReturn_a|MaybeReturn_b|MaybeReturn_c
Test case 115	Live_a|Live_b|NotLive_c	ReadOnly_a|ReadWrite_b|ReadOnly_c	MaybeReturn_a|MaybeReturn_b|NeverReturn_c
Test case 116	Live_a|Live_b|NotLive_c	ReadOnly_a|ReadWrite_b|ReadOnly_c	MaybeReturn_a|NeverReturn_b|MaybeReturn_c
Test case 117	Live_a|Live_b|NotLive_c	ReadOnly_a|ReadWrite_b|ReadOnly_c	MaybeReturn_a|NeverReturn_b|NeverReturn_c
Test case 118	Live_a|Live_b|NotLive_c	ReadOnly_a|ReadWrite_b|ReadOnly_c	NeverReturn_a|MaybeReturn_b|MaybeReturn_c
Test case 119	Live_a|Live_b|NotLive_c	ReadOnly_a|ReadWrite_b|ReadOnly_c	NeverReturn_a|MaybeReturn_b|NeverReturn_c
Test case 120	Live_a|Live_b|NotLive_c	ReadOnly_a|ReadWrite_b|ReadOnly_c	NeverReturn_a|NeverReturn_b|MaybeReturn_c
Test case 121	Live_a|Live_b|NotLive_c	ReadOnly_a|ReadWrite_b|ReadOnly_c	NeverReturn_a|NeverReturn_b|NeverReturn_c
Test case 122	Live_a|Live_b|NotLive_c	ReadOnly_a|ReadWrite_b|ReadWrite_c	AlwaysReturn_a
Test case 123	Live_a|Live_b|NotLive_c	ReadOnly_a|ReadWrite_b|ReadWrite_c	AlwaysReturn_b
Test case 124	Live_a|Live_b|NotLive_c	ReadOnly_a|ReadWrite_b|ReadWrite_c	AlwaysReturn_c
Test case 125	Live_a|Live_b|NotLive_c	ReadOnly_a|ReadWrite_b|ReadWrite_c	MaybeReturn_a|MaybeReturn_b|MaybeReturn_c
Test case 126	Live_a|Live_b|NotLive_c	ReadOnly_a|ReadWrite_b|ReadWrite_c	MaybeReturn_a|MaybeReturn_b|NeverReturn_c
Test case 127	Live_a|Live_b|NotLive_c	ReadOnly_a|ReadWrite_b|ReadWrite_c	MaybeReturn_a|NeverReturn_b|MaybeReturn_c
Test case 128	Live_a|Live_b|NotLive_c	ReadOnly_a|ReadWrite_b|ReadWrite_c	MaybeReturn_a|NeverReturn_b|NeverReturn_c
Test case 129	Live_a|Live_b|NotLive_c	ReadOnly_a|ReadWrite_b|ReadWrite_c	NeverReturn_a|MaybeReturn_b|MaybeReturn_c
Test case 130	Live_a|Live_b|NotLive_c	ReadOnly_a|ReadWrite_b|ReadWrite_c	NeverReturn_a|MaybeReturn_b|NeverReturn_c
Test case 131	Live_a|Live_b|NotLive_c	ReadOnly_a|ReadWrite_b|ReadWrite_c	NeverReturn_a|NeverReturn_b|MaybeReturn_c
Test case 132	Live_a|Live_b|NotLive_c	ReadOnly_a|ReadWrite_b|ReadWrite_c	NeverReturn_a|NeverReturn_b|NeverReturn_c
Test case 133	Live_a|Live_b|NotLive_c	ReadWrite_a|ReadOnly_b|ReadOnly_c	AlwaysReturn_a
Test case 134	Live_a|Live_b|NotLive_c	ReadWrite_a|ReadOnly_b|ReadOnly_c	AlwaysReturn_b
Test case 135	Live_a|Live_b|NotLive_c	ReadWrite_a|ReadOnly_b|ReadOnly_c	AlwaysReturn_c
Test case 136	Live_a|Live_b|NotLive_c	ReadWrite_a|ReadOnly_b|ReadOnly_c	MaybeReturn_a|MaybeReturn_b|MaybeReturn_c
Test case 137	Live_a|Live_b|NotLive_c	ReadWrite_a|ReadOnly_b|ReadOnly_c	MaybeReturn_a|MaybeReturn_b|NeverReturn_c
Test case 138	Live_a|Live_b|NotLive_c	ReadWrite_a|ReadOnly_b|ReadOnly_c	MaybeReturn_a|NeverReturn_b|MaybeReturn_c
Test case 139	Live_a|Live_b|NotLive_c	ReadWrite_a|ReadOnly_b|ReadOnly_c	MaybeReturn_a|NeverReturn_b|NeverReturn_c
Test case 140	Live_a|Live_b|NotLive_c	ReadWrite_a|ReadOnly_b|ReadOnly_c	NeverReturn_a|MaybeReturn_b|MaybeReturn_c
Test case 141	Live_a|Live_b|NotLive_c	ReadWrite_a|ReadOnly_b|ReadOnly_c	NeverReturn_a|MaybeReturn_b|NeverReturn_c
Test case 142	Live_a|Live_b|NotLive_c	ReadWrite_a|ReadOnly_b|ReadOnly_c	NeverReturn_a|NeverReturn_b|MaybeReturn_c
Test case 143	Live_a|Live_b|NotLive_c	ReadWrite_a|ReadOnly_b|ReadOnly_c	NeverReturn_a|NeverReturn_b|NeverReturn_c
Test case 144	Live_a|Live_b|NotLive_c	ReadWrite_a|ReadOnly_b|ReadWrite_c	AlwaysReturn_a
Test case 145	Live_a|Live_b|NotLive_c	ReadWrite_a|ReadOnly_b|ReadWrite_c	AlwaysReturn_b
Test case 146	Live_a|Live_b|NotLive_c	ReadWrite_a|ReadOnly_b|ReadWrite_c	AlwaysReturn_c
Test case 147	Live_a|Live_b|NotLive_c	ReadWrite_a|ReadOnly_b|ReadWrite_c	MaybeReturn_a|MaybeReturn_b|MaybeReturn_c
Test case 148	Live_a|Live_b|NotLive_c	ReadWrite_a|ReadOnly_b|ReadWrite_c	MaybeReturn_a|MaybeReturn_b|NeverReturn_c
Test case 149	Live_a|Live_b|NotLive_c	ReadWrite_a|ReadOnly_b|ReadWrite_c	MaybeReturn_a|NeverReturn_b|MaybeReturn_c
Test case 150	Live_a|Live_b|NotLive_c	ReadWrite_a|ReadOnly_b|ReadWrite_c	MaybeReturn_a|NeverReturn_b|NeverReturn_c
Test case 151	Live_a|Live_b|NotLive_c	ReadWrite_a|ReadOnly_b|ReadWrite_c	NeverReturn_a|MaybeReturn_b|MaybeReturn_c
Test case 152	Live_a|Live_b|NotLive_c	ReadWrite_a|ReadOnly_b|ReadWrite_c	NeverReturn_a|MaybeReturn_b|NeverReturn_c
Test case 153	Live_a|Live_b|NotLive_c	ReadWrite_a|ReadOnly_b|ReadWrite_c	NeverReturn_a|NeverReturn_b|MaybeReturn_c
Test case 154	Live_a|Live_b|NotLive_c	ReadWrite_a|ReadOnly_b|ReadWrite_c	NeverReturn_a|NeverReturn_b|NeverReturn_c
Test case 155	Live_a|Live_b|NotLive_c	ReadWrite_a|ReadWrite_b|ReadOnly_c	AlwaysReturn_a
Test case 156	Live_a|Live_b|NotLive_c	ReadWrite_a|ReadWrite_b|ReadOnly_c	AlwaysReturn_b
Test case 157	Live_a|Live_b|NotLive_c	ReadWrite_a|ReadWrite_b|ReadOnly_c	AlwaysReturn_c
Test case 158	Live_a|Live_b|NotLive_c	ReadWrite_a|ReadWrite_b|ReadOnly_c	MaybeReturn_a|MaybeReturn_b|MaybeReturn_c
Test case 159	Live_a|Live_b|NotLive_c	ReadWrite_a|ReadWrite_b|ReadOnly_c	MaybeReturn_a|MaybeReturn_b|NeverReturn_c
Test case 160	Live_a|Live_b|NotLive_c	ReadWrite_a|ReadWrite_b|ReadOnly_c	MaybeReturn_a|NeverReturn_b|MaybeReturn_c
Test case 161	Live_a|Live_b|NotLive_c	ReadWrite_a|ReadWrite_b|ReadOnly_c	MaybeReturn_a|NeverReturn_b|NeverReturn_c
Test case 162	Live_a|Live_b|NotLive_c	ReadWrite_a|ReadWrite_b|ReadOnly_c	NeverReturn_a|MaybeReturn_b|MaybeReturn_c
Test case 163	Live_a|Live_b|NotLive_c	ReadWrite_a|ReadWrite_b|ReadOnly_c	NeverReturn_a|MaybeReturn_b|NeverReturn_c
Test case 164	Live_a|Live_b|NotLive_c	ReadWrite_a|ReadWrite_b|ReadOnly_c	NeverReturn_a|NeverReturn_b|MaybeReturn_c
Test case 165	Live_a|Live_b|NotLive_c	ReadWrite_a|ReadWrite_b|ReadOnly_c	NeverReturn_a|NeverReturn_b|NeverReturn_c
Test case 166	Live_a|Live_b|NotLive_c	ReadWrite_a|ReadWrite_b|ReadWrite_c	AlwaysReturn_a
Test case 167	Live_a|Live_b|NotLive_c	ReadWrite_a|ReadWrite_b|ReadWrite_c	AlwaysReturn_b
Test case 168	Live_a|Live_b|NotLive_c	ReadWrite_a|ReadWrite_b|ReadWrite_c	AlwaysReturn_c
Test case 169	Live_a|Live_b|NotLive_c	ReadWrite_a|ReadWrite_b|ReadWrite_c	MaybeReturn_a|MaybeReturn_b|MaybeReturn_c
Test case 170	Live_a|Live_b|NotLive_c	ReadWrite_a|ReadWrite_b|ReadWrite_c	MaybeReturn_a|MaybeReturn_b|NeverReturn_c
Test case 171	Live_a|Live_b|NotLive_c	ReadWrite_a|ReadWrite_b|ReadWrite_c	MaybeReturn_a|NeverReturn_b|MaybeReturn_c
Test case 172	Live_a|Live_b|NotLive_c	ReadWrite_a|ReadWrite_b|ReadWrite_c	MaybeReturn_a|NeverReturn_b|NeverReturn_c
Test case 173	Live_a|Live_b|NotLive_c	ReadWrite_a|ReadWrite_b|ReadWrite_c	NeverReturn_a|MaybeReturn_b|MaybeReturn_c
Test case 174	Live_a|Live_b|NotLive_c	ReadWrite_a|ReadWrite_b|ReadWrite_c	NeverReturn_a|MaybeReturn_b|NeverReturn_c
Test case 175	Live_a|Live_b|NotLive_c	ReadWrite_a|ReadWrite_b|ReadWrite_c	NeverReturn_a|NeverReturn_b|MaybeReturn_c
Test case 176	Live_a|Live_b|NotLive_c	ReadWrite_a|ReadWrite_b|ReadWrite_c	NeverReturn_a|NeverReturn_b|NeverReturn_c
Test case 177	Live_a|NotLive_b|Live_c	ReadOnly_a|ReadOnly_b|ReadOnly_c	AlwaysReturn_a
Test case 178	Live_a|NotLive_b|Live_c	ReadOnly_a|ReadOnly_b|ReadOnly_c	AlwaysReturn_b
Test case 179	Live_a|NotLive_b|Live_c	ReadOnly_a|ReadOnly_b|ReadOnly_c	AlwaysReturn_c
Test case 180	Live_a|NotLive_b|Live_c	ReadOnly_a|ReadOnly_b|ReadOnly_c	MaybeReturn_a|MaybeReturn_b|MaybeReturn_c
Test case 181	Live_a|NotLive_b|Live_c	ReadOnly_a|ReadOnly_b|ReadOnly_c	MaybeReturn_a|MaybeReturn_b|NeverReturn_c
Test case 182	Live_a|NotLive_b|Live_c	ReadOnly_a|ReadOnly_b|ReadOnly_c	MaybeReturn_a|NeverReturn_b|MaybeReturn_c
Test case 183	Live_a|NotLive_b|Live_c	ReadOnly_a|ReadOnly_b|ReadOnly_c	MaybeReturn_a|NeverReturn_b|NeverReturn_c
Test case 184	Live_a|NotLive_b|Live_c	ReadOnly_a|ReadOnly_b|ReadOnly_c	NeverReturn_a|MaybeReturn_b|MaybeReturn_c
Test case 185	Live_a|NotLive_b|Live_c	ReadOnly_a|ReadOnly_b|ReadOnly_c	NeverReturn_a|MaybeReturn_b|NeverReturn_c
Test case 186	Live_a|NotLive_b|Live_c	ReadOnly_a|ReadOnly_b|ReadOnly_c	NeverReturn_a|NeverReturn_b|MaybeReturn_c
Test case 187	Live_a|NotLive_b|Live_c	ReadOnly_a|ReadOnly_b|ReadOnly_c	NeverReturn_a|NeverReturn_b|NeverReturn_c
Test case 188	Live_a|NotLive_b|Live_c	ReadOnly_a|ReadOnly_b|ReadWrite_c	AlwaysReturn_a
Test case 189	Live_a|NotLive_b|Live_c	ReadOnly_a|ReadOnly_b|ReadWrite_c	AlwaysReturn_b
Test case 190	Live_a|NotLive_b|Live_c	ReadOnly_a|ReadOnly_b|ReadWrite_c	AlwaysReturn_c
Test case 191	Live_a|NotLive_b|Live_c	ReadOnly_a|ReadOnly_b|ReadWrite_c	MaybeReturn_a|MaybeReturn_b|MaybeReturn_c
Test case 192	Live_a|NotLive_b|Live_c	ReadOnly_a|ReadOnly_b|ReadWrite_c	MaybeReturn_a|MaybeReturn_b|NeverReturn_c
Test case 193	Live_a|NotLive_b|Live_c	ReadOnly_a|ReadOnly_b|ReadWrite_c	MaybeReturn_a|NeverReturn_b|MaybeReturn_c
Test case 194	Live_a|NotLive_b|Live_c	ReadOnly_a|ReadOnly_b|ReadWrite_c	MaybeReturn_a|NeverReturn_b|NeverReturn_c
Test case 195	Live_a|NotLive_b|Live_c	ReadOnly_a|ReadOnly_b|ReadWrite_c	NeverReturn_a|MaybeReturn_b|MaybeReturn_c
Test case 196	Live_a|NotLive_b|Live_c	ReadOnly_a|ReadOnly_b|ReadWrite_c	NeverReturn_a|MaybeReturn_b|NeverReturn_c
Test case 197	Live_a|NotLive_b|Live_c	ReadOnly_a|ReadOnly_b|ReadWrite_c	NeverReturn_a|NeverReturn_b|MaybeReturn_c
Test case 198	Live_a|NotLive_b|Live_c	ReadOnly_a|ReadOnly_b|ReadWrite_c	NeverReturn_a|NeverReturn_b|NeverReturn_c
Test case 199	Live_a|NotLive_b|Live_c	ReadOnly_a|ReadWrite_b|ReadOnly_c	AlwaysReturn_a
Test case 200	Live_a|NotLive_b|Live_c	ReadOnly_a|ReadWrite_b|ReadOnly_c	AlwaysReturn_b
Test case 201	Live_a|NotLive_b|Live_c	ReadOnly_a|ReadWrite_b|ReadOnly_c	AlwaysReturn_c
Test case 202	Live_a|NotLive_b|Live_c	ReadOnly_a|ReadWrite_b|ReadOnly_c	MaybeReturn_a|MaybeReturn_b|MaybeReturn_c
Test case 203	Live_a|NotLive_b|Live_c	ReadOnly_a|ReadWrite_b|ReadOnly_c	MaybeReturn_a|MaybeReturn_b|NeverReturn_c
Test case 204	Live_a|NotLive_b|Live_c	ReadOnly_a|ReadWrite_b|ReadOnly_c	MaybeReturn_a|NeverReturn_b|MaybeReturn_c
Test case 205	Live_a|NotLive_b|Live_c	ReadOnly_a|ReadWrite_b|ReadOnly_c	MaybeReturn_a|NeverReturn_b|NeverReturn_c
Test case 206	Live_a|NotLive_b|Live_c	ReadOnly_a|ReadWrite_b|ReadOnly_c	NeverReturn_a|MaybeReturn_b|MaybeReturn_c
Test case 207	Live_a|NotLive_b|Live_c	ReadOnly_a|ReadWrite_b|ReadOnly_c	NeverReturn_a|MaybeReturn_b|NeverReturn_c
Test case 208	Live_a|NotLive_b|Live_c	ReadOnly_a|ReadWrite_b|ReadOnly_c	NeverReturn_a|NeverReturn_b|MaybeReturn_c
Test case 209	Live_a|NotLive_b|Live_c	ReadOnly_a|ReadWrite_b|ReadOnly_c	NeverReturn_a|NeverReturn_b|NeverReturn_c
Test case 210	Live_a|NotLive_b|Live_c	ReadOnly_a|ReadWrite_b|ReadWrite_c	AlwaysReturn_a
Test case 211	Live_a|NotLive_b|Live_c	ReadOnly_a|ReadWrite_b|ReadWrite_c	AlwaysReturn_b
Test case 212	Live_a|NotLive_b|Live_c	ReadOnly_a|ReadWrite_b|ReadWrite_c	AlwaysReturn_c
Test case 213	Live_a|NotLive_b|Live_c	ReadOnly_a|ReadWrite_b|ReadWrite_c	MaybeReturn_a|MaybeReturn_b|MaybeReturn_c
Test case 214	Live_a|NotLive_b|Live_c	ReadOnly_a|ReadWrite_b|ReadWrite_c	MaybeReturn_a|MaybeReturn_b|NeverReturn_c
Test case 215	Live_a|NotLive_b|Live_c	ReadOnly_a|ReadWrite_b|ReadWrite_c	MaybeReturn_a|NeverReturn_b|MaybeReturn_c
Test case 216	Live_a|NotLive_b|Live_c	ReadOnly_a|ReadWrite_b|ReadWrite_c	MaybeReturn_a|NeverReturn_b|NeverReturn_c
Test case 217	Live_a|NotLive_b|Live_c	ReadOnly_a|ReadWrite_b|ReadWrite_c	NeverReturn_a|MaybeReturn_b|MaybeReturn_c
Test case 218	Live_a|NotLive_b|Live_c	ReadOnly_a|ReadWrite_b|ReadWrite_c	NeverReturn_a|MaybeReturn_b|NeverReturn_c
Test case 219	Live_a|NotLive_b|Live_c	ReadOnly_a|ReadWrite_b|ReadWrite_c	NeverReturn_a|NeverReturn_b|MaybeReturn_c
Test case 220	Live_a|NotLive_b|Live_c	ReadOnly_a|ReadWrite_b|ReadWrite_c	NeverReturn_a|NeverReturn_b|NeverReturn_c
Test case 221	Live_a|NotLive_b|Live_c	ReadWrite_a|ReadOnly_b|ReadOnly_c	AlwaysReturn_a
Test case 222	Live_a|NotLive_b|Live_c	ReadWrite_a|ReadOnly_b|ReadOnly_c	AlwaysReturn_b
Test case 223	Live_a|NotLive_b|Live_c	ReadWrite_a|ReadOnly_b|ReadOnly_c	AlwaysReturn_c
Test case 224	Live_a|NotLive_b|Live_c	ReadWrite_a|ReadOnly_b|ReadOnly_c	MaybeReturn_a|MaybeReturn_b|MaybeReturn_c
Test case 225	Live_a|NotLive_b|Live_c	ReadWrite_a|ReadOnly_b|ReadOnly_c	MaybeReturn_a|MaybeReturn_b|NeverReturn_c
Test case 226	Live_a|NotLive_b|Live_c	ReadWrite_a|ReadOnly_b|ReadOnly_c	MaybeReturn_a|NeverReturn_b|MaybeReturn_c
Test case 227	Live_a|NotLive_b|Live_c	ReadWrite_a|ReadOnly_b|ReadOnly_c	MaybeReturn_a|NeverReturn_b|NeverReturn_c
Test case 228	Live_a|NotLive_b|Live_c	ReadWrite_a|ReadOnly_b|ReadOnly_c	NeverReturn_a|MaybeReturn_b|MaybeReturn_c
Test case 229	Live_a|NotLive_b|Live_c	ReadWrite_a|ReadOnly_b|ReadOnly_c	NeverReturn_a|MaybeReturn_b|NeverReturn_c
Test case 230	Live_a|NotLive_b|Live_c	ReadWrite_a|ReadOnly_b|ReadOnly_c	NeverReturn_a|NeverReturn_b|MaybeReturn_c
Test case 231	Live_a|NotLive_b|Live_c	ReadWrite_a|ReadOnly_b|ReadOnly_c	NeverReturn_a|NeverReturn_b|NeverReturn_c
Test case 232	Live_a|NotLive_b|Live_c	ReadWrite_a|ReadOnly_b|ReadWrite_c	AlwaysReturn_a
Test case 233	Live_a|NotLive_b|Live_c	ReadWrite_a|ReadOnly_b|ReadWrite_c	AlwaysReturn_b
Test case 234	Live_a|NotLive_b|Live_c	ReadWrite_a|ReadOnly_b|ReadWrite_c	AlwaysReturn_c
Test case 235	Live_a|NotLive_b|Live_c	ReadWrite_a|ReadOnly_b|ReadWrite_c	MaybeReturn_a|MaybeReturn_b|MaybeReturn_c
Test case 236	Live_a|NotLive_b|Live_c	ReadWrite_a|ReadOnly_b|ReadWrite_c	MaybeReturn_a|MaybeReturn_b|NeverReturn_c
Test case 237	Live_a|NotLive_b|Live_c	ReadWrite_a|ReadOnly_b|ReadWrite_c	MaybeReturn_a|NeverReturn_b|MaybeReturn_c
Test case 238	Live_a|NotLive_b|Live_c	ReadWrite_a|ReadOnly_b|ReadWrite_c	MaybeReturn_a|NeverReturn_b|NeverReturn_c
Test case 239	Live_a|NotLive_b|Live_c	ReadWrite_a|ReadOnly_b|ReadWrite_c	NeverReturn_a|MaybeReturn_b|MaybeReturn_c
Test case 240	Live_a|NotLive_b|Live_c	ReadWrite_a|ReadOnly_b|ReadWrite_c	NeverReturn_a|MaybeReturn_b|NeverReturn_c
Test case 241	Live_a|NotLive_b|Live_c	ReadWrite_a|ReadOnly_b|ReadWrite_c	NeverReturn_a|NeverReturn_b|MaybeReturn_c
Test case 242	Live_a|NotLive_b|Live_c	ReadWrite_a|ReadOnly_b|ReadWrite_c	NeverReturn_a|NeverReturn_b|NeverReturn_c
Test case 243	Live_a|NotLive_b|Live_c	ReadWrite_a|ReadWrite_b|ReadOnly_c	AlwaysReturn_a
Test case 244	Live_a|NotLive_b|Live_c	ReadWrite_a|ReadWrite_b|ReadOnly_c	AlwaysReturn_b
Test case 245	Live_a|NotLive_b|Live_c	ReadWrite_a|ReadWrite_b|ReadOnly_c	AlwaysReturn_c
Test case 246	Live_a|NotLive_b|Live_c	ReadWrite_a|ReadWrite_b|ReadOnly_c	MaybeReturn_a|MaybeReturn_b|MaybeReturn_c
Test case 247	Live_a|NotLive_b|Live_c	ReadWrite_a|ReadWrite_b|ReadOnly_c	MaybeReturn_a|MaybeReturn_b|NeverReturn_c
Test case 248	Live_a|NotLive_b|Live_c	ReadWrite_a|ReadWrite_b|ReadOnly_c	MaybeReturn_a|NeverReturn_b|MaybeReturn_c
Test case 249	Live_a|NotLive_b|Live_c	ReadWrite_a|ReadWrite_b|ReadOnly_c	MaybeReturn_a|NeverReturn_b|NeverReturn_c
Test case 250	Live_a|NotLive_b|Live_c	ReadWrite_a|ReadWrite_b|ReadOnly_c	NeverReturn_a|MaybeReturn_b|MaybeReturn_c
Test case 251	Live_a|NotLive_b|Live_c	ReadWrite_a|ReadWrite_b|ReadOnly_c	NeverReturn_a|MaybeReturn_b|NeverReturn_c
Test case 252	Live_a|NotLive_b|Live_c	ReadWrite_a|ReadWrite_b|ReadOnly_c	NeverReturn_a|NeverReturn_b|MaybeReturn_c
Test case 253	Live_a|NotLive_b|Live_c	ReadWrite_a|ReadWrite_b|ReadOnly_c	NeverReturn_a|NeverReturn_b|NeverReturn_c
Test case 254	Live_a|NotLive_b|Live_c	ReadWrite_a|ReadWrite_b|ReadWrite_c	AlwaysReturn_a
Test case 255	Live_a|NotLive_b|Live_c	ReadWrite_a|ReadWrite_b|ReadWrite_c	AlwaysReturn_b
Test case 256	Live_a|NotLive_b|Live_c	ReadWrite_a|ReadWrite_b|ReadWrite_c	AlwaysReturn_c
Test case 257	Live_a|NotLive_b|Live_c	ReadWrite_a|ReadWrite_b|ReadWrite_c	MaybeReturn_a|MaybeReturn_b|MaybeReturn_c
Test case 258	Live_a|NotLive_b|Live_c	ReadWrite_a|ReadWrite_b|ReadWrite_c	MaybeReturn_a|MaybeReturn_b|NeverReturn_c
Test case 259	Live_a|NotLive_b|Live_c	ReadWrite_a|ReadWrite_b|ReadWrite_c	MaybeReturn_a|NeverReturn_b|MaybeReturn_c
Test case 260	Live_a|NotLive_b|Live_c	ReadWrite_a|ReadWrite_b|ReadWrite_c	MaybeReturn_a|NeverReturn_b|NeverReturn_c
Test case 261	Live_a|NotLive_b|Live_c	ReadWrite_a|ReadWrite_b|ReadWrite_c	NeverReturn_a|MaybeReturn_b|MaybeReturn_c
Test case 262	Live_a|NotLive_b|Live_c	ReadWrite_a|ReadWrite_b|ReadWrite_c	NeverReturn_a|MaybeReturn_b|NeverReturn_c
Test case 263	Live_a|NotLive_b|Live_c	ReadWrite_a|ReadWrite_b|ReadWrite_c	NeverReturn_a|NeverReturn_b|MaybeReturn_c
Test case 264	Live_a|NotLive_b|Live_c	ReadWrite_a|ReadWrite_b|ReadWrite_c	NeverReturn_a|NeverReturn_b|NeverReturn_c
Test case 265	Live_a|NotLive_b|NotLive_c	ReadOnly_a|ReadOnly_b|ReadOnly_c	AlwaysReturn_a
Test case 266	Live_a|NotLive_b|NotLive_c	ReadOnly_a|ReadOnly_b|ReadOnly_c	AlwaysReturn_b
Test case 267	Live_a|NotLive_b|NotLive_c	ReadOnly_a|ReadOnly_b|ReadOnly_c	AlwaysReturn_c
Test case 268	Live_a|NotLive_b|NotLive_c	ReadOnly_a|ReadOnly_b|ReadOnly_c	MaybeReturn_a|MaybeReturn_b|MaybeReturn_c
Test case 269	Live_a|NotLive_b|NotLive_c	ReadOnly_a|ReadOnly_b|ReadOnly_c	MaybeReturn_a|MaybeReturn_b|NeverReturn_c
Test case 270	Live_a|NotLive_b|NotLive_c	ReadOnly_a|ReadOnly_b|ReadOnly_c	MaybeReturn_a|NeverReturn_b|MaybeReturn_c
Test case 271	Live_a|NotLive_b|NotLive_c	ReadOnly_a|ReadOnly_b|ReadOnly_c	MaybeReturn_a|NeverReturn_b|NeverReturn_c
Test case 272	Live_a|NotLive_b|NotLive_c	ReadOnly_a|ReadOnly_b|ReadOnly_c	NeverReturn_a|MaybeReturn_b|MaybeReturn_c
Test case 273	Live_a|NotLive_b|NotLive_c	ReadOnly_a|ReadOnly_b|ReadOnly_c	NeverReturn_a|MaybeReturn_b|NeverReturn_c
Test case 274	Live_a|NotLive_b|NotLive_c	ReadOnly_a|ReadOnly_b|ReadOnly_c	NeverReturn_a|NeverReturn_b|MaybeReturn_c
Test case 275	Live_a|NotLive_b|NotLive_c	ReadOnly_a|ReadOnly_b|ReadOnly_c	NeverReturn_a|NeverReturn_b|NeverReturn_c
Test case 276	Live_a|NotLive_b|NotLive_c	ReadOnly_a|ReadOnly_b|ReadWrite_c	AlwaysReturn_a
Test case 277	Live_a|NotLive_b|NotLive_c	ReadOnly_a|ReadOnly_b|ReadWrite_c	AlwaysReturn_b
Test case 278	Live_a|NotLive_b|NotLive_c	ReadOnly_a|ReadOnly_b|ReadWrite_c	AlwaysReturn_c
Test case 279	Live_a|NotLive_b|NotLive_c	ReadOnly_a|ReadOnly_b|ReadWrite_c	MaybeReturn_a|MaybeReturn_b|MaybeReturn_c
Test case 280	Live_a|NotLive_b|NotLive_c	ReadOnly_a|ReadOnly_b|ReadWrite_c	MaybeReturn_a|MaybeReturn_b|NeverReturn_c
Test case 281	Live_a|NotLive_b|NotLive_c	ReadOnly_a|ReadOnly_b|ReadWrite_c	MaybeReturn_a|NeverReturn_b|MaybeReturn_c
Test case 282	Live_a|NotLive_b|NotLive_c	ReadOnly_a|ReadOnly_b|ReadWrite_c	MaybeReturn_a|NeverReturn_b|NeverReturn_c
Test case 283	Live_a|NotLive_b|NotLive_c	ReadOnly_a|ReadOnly_b|ReadWrite_c	NeverReturn_a|MaybeReturn_b|MaybeReturn_c
Test case 284	Live_a|NotLive_b|NotLive_c	ReadOnly_a|ReadOnly_b|ReadWrite_c	NeverReturn_a|MaybeReturn_b|NeverReturn_c
Test case 285	Live_a|NotLive_b|NotLive_c	ReadOnly_a|ReadOnly_b|ReadWrite_c	NeverReturn_a|NeverReturn_b|MaybeReturn_c
Test case 286	Live_a|NotLive_b|NotLive_c	ReadOnly_a|ReadOnly_b|ReadWrite_c	NeverReturn_a|NeverReturn_b|NeverReturn_c
Test case 287	Live_a|NotLive_b|NotLive_c	ReadOnly_a|ReadWrite_b|ReadOnly_c	AlwaysReturn_a
Test case 288	Live_a|NotLive_b|NotLive_c	ReadOnly_a|ReadWrite_b|ReadOnly_c	AlwaysReturn_b
Test case 289	Live_a|NotLive_b|NotLive_c	ReadOnly_a|ReadWrite_b|ReadOnly_c	AlwaysReturn_c
Test case 290	Live_a|NotLive_b|NotLive_c	ReadOnly_a|ReadWrite_b|ReadOnly_c	MaybeReturn_a|MaybeReturn_b|MaybeReturn_c
Test case 291	Live_a|NotLive_b|NotLive_c	ReadOnly_a|ReadWrite_b|ReadOnly_c	MaybeReturn_a|MaybeReturn_b|NeverReturn_c
Test case 292	Live_a|NotLive_b|NotLive_c	ReadOnly_a|ReadWrite_b|ReadOnly_c	MaybeReturn_a|NeverReturn_b|MaybeReturn_c
Test case 293	Live_a|NotLive_b|NotLive_c	ReadOnly_a|ReadWrite_b|ReadOnly_c	MaybeReturn_a|NeverReturn_b|NeverReturn_c
Test case 294	Live_a|NotLive_b|NotLive_c	ReadOnly_a|ReadWrite_b|ReadOnly_c	NeverReturn_a|MaybeReturn_b|MaybeReturn_c
Test case 295	Live_a|NotLive_b|NotLive_c	ReadOnly_a|ReadWrite_b|ReadOnly_c	NeverReturn_a|MaybeReturn_b|NeverReturn_c
Test case 296	Live_a|NotLive_b|NotLive_c	ReadOnly_a|ReadWrite_b|ReadOnly_c	NeverReturn_a|NeverReturn_b|MaybeReturn_c
Test case 297	Live_a|NotLive_b|NotLive_c	ReadOnly_a|ReadWrite_b|ReadOnly_c	NeverReturn_a|NeverReturn_b|NeverReturn_c
Test case 298	Live_a|NotLive_b|NotLive_c	ReadOnly_a|ReadWrite_b|ReadWrite_c	AlwaysReturn_a
Test case 299	Live_a|NotLive_b|NotLive_c	ReadOnly_a|ReadWrite_b|ReadWrite_c	AlwaysReturn_b
Test case 300	Live_a|NotLive_b|NotLive_c	ReadOnly_a|ReadWrite_b|ReadWrite_c	AlwaysReturn_c
Test case 301	Live_a|NotLive_b|NotLive_c	ReadOnly_a|ReadWrite_b|ReadWrite_c	MaybeReturn_a|MaybeReturn_b|MaybeReturn_c
Test case 302	Live_a|NotLive_b|NotLive_c	ReadOnly_a|ReadWrite_b|ReadWrite_c	MaybeReturn_a|MaybeReturn_b|NeverReturn_c
Test case 303	Live_a|NotLive_b|NotLive_c	ReadOnly_a|ReadWrite_b|ReadWrite_c	MaybeReturn_a|NeverReturn_b|MaybeReturn_c
